DATE,REGION,FATAL,SERIOUS,NOINJURY,OTHER,Total.Accidents
1/01/2016,EASTERN REGION,0,1,0,5,6
2/01/2016,EASTERN REGION,0,3,0,1,4
3/01/2016,EASTERN REGION,0,1,0,5,6
4/01/2016,EASTERN REGION,0,2,0,2,4
5/01/2016,EASTERN REGION,0,1,0,6,7
6/01/2016,EASTERN REGION,0,2,0,1,3
7/01/2016,EASTERN REGION,0,0,0,2,2
8/01/2016,EASTERN REGION,0,1,0,1,2
9/01/2016,EASTERN REGION,0,1,0,5,6
10/01/2016,EASTERN REGION,1,1,0,2,4
11/01/2016,EASTERN REGION,0,0,0,4,4
12/01/2016,EASTERN REGION,0,1,0,0,1
13/01/2016,EASTERN REGION,0,0,0,0,0
14/01/2016,EASTERN REGION,0,4,0,4,8
15/01/2016,EASTERN REGION,0,0,0,2,2
16/01/2016,EASTERN REGION,0,2,0,1,3
17/01/2016,EASTERN REGION,0,2,0,3,5
18/01/2016,EASTERN REGION,0,0,0,3,3
19/01/2016,EASTERN REGION,0,0,0,4,4
20/01/2016,EASTERN REGION,0,1,0,5,6
21/01/2016,EASTERN REGION,0,1,0,0,1
22/01/2016,EASTERN REGION,0,0,0,5,5
23/01/2016,EASTERN REGION,0,1,0,2,3
24/01/2016,EASTERN REGION,0,1,0,3,4
25/01/2016,EASTERN REGION,0,0,0,4,4
26/01/2016,EASTERN REGION,0,1,0,1,2
27/01/2016,EASTERN REGION,0,2,0,2,4
28/01/2016,EASTERN REGION,1,1,0,2,4
29/01/2016,EASTERN REGION,0,1,0,2,3
30/01/2016,EASTERN REGION,0,1,0,3,4
31/01/2016,EASTERN REGION,0,1,0,1,2
1/02/2016,EASTERN REGION,0,0,0,3,3
2/02/2016,EASTERN REGION,0,1,0,1,2
3/02/2016,EASTERN REGION,0,0,0,2,2
4/02/2016,EASTERN REGION,1,0,0,1,2
5/02/2016,EASTERN REGION,0,3,0,3,6
6/02/2016,EASTERN REGION,0,0,0,1,1
7/02/2016,EASTERN REGION,0,8,0,1,9
8/02/2016,EASTERN REGION,1,0,0,5,6
9/02/2016,EASTERN REGION,0,1,0,0,1
10/02/2016,EASTERN REGION,0,1,0,4,5
11/02/2016,EASTERN REGION,0,1,0,2,3
12/02/2016,EASTERN REGION,0,2,0,1,3
13/02/2016,EASTERN REGION,0,1,0,1,2
14/02/2016,EASTERN REGION,0,0,0,3,3
15/02/2016,EASTERN REGION,0,0,0,1,1
16/02/2016,EASTERN REGION,0,1,0,1,2
17/02/2016,EASTERN REGION,0,3,0,3,6
18/02/2016,EASTERN REGION,0,2,0,2,4
19/02/2016,EASTERN REGION,0,0,0,2,2
20/02/2016,EASTERN REGION,1,2,0,2,5
21/02/2016,EASTERN REGION,0,1,0,2,3
22/02/2016,EASTERN REGION,1,0,0,4,5
23/02/2016,EASTERN REGION,1,0,0,3,4
24/02/2016,EASTERN REGION,0,2,0,5,7
25/02/2016,EASTERN REGION,0,1,0,0,1
26/02/2016,EASTERN REGION,1,1,0,0,2
27/02/2016,EASTERN REGION,0,3,0,3,6
28/02/2016,EASTERN REGION,0,1,0,2,3
29/02/2016,EASTERN REGION,0,0,0,2,2
1/03/2016,EASTERN REGION,1,1,0,0,2
2/03/2016,EASTERN REGION,0,1,0,3,4
3/03/2016,EASTERN REGION,1,0,0,1,2
4/03/2016,EASTERN REGION,0,1,0,2,3
5/03/2016,EASTERN REGION,0,0,0,3,3
6/03/2016,EASTERN REGION,0,1,0,4,5
7/03/2016,EASTERN REGION,0,0,0,1,1
8/03/2016,EASTERN REGION,0,1,0,1,2
9/03/2016,EASTERN REGION,0,1,0,1,2
10/03/2016,EASTERN REGION,0,1,0,5,6
11/03/2016,EASTERN REGION,0,4,0,3,7
12/03/2016,EASTERN REGION,0,0,0,4,4
13/03/2016,EASTERN REGION,0,2,0,4,6
14/03/2016,EASTERN REGION,1,2,0,5,8
15/03/2016,EASTERN REGION,0,0,0,0,0
16/03/2016,EASTERN REGION,0,0,0,0,0
17/03/2016,EASTERN REGION,0,0,0,0,0
18/03/2016,EASTERN REGION,0,0,0,5,5
19/03/2016,EASTERN REGION,0,0,0,0,0
20/03/2016,EASTERN REGION,0,2,0,3,5
21/03/2016,EASTERN REGION,0,2,0,2,4
22/03/2016,EASTERN REGION,0,0,0,5,5
23/03/2016,EASTERN REGION,0,1,0,1,2
24/03/2016,EASTERN REGION,0,0,0,1,1
25/03/2016,EASTERN REGION,0,5,0,2,7
26/03/2016,EASTERN REGION,0,3,0,7,10
27/03/2016,EASTERN REGION,0,0,0,2,2
28/03/2016,EASTERN REGION,0,1,0,0,1
29/03/2016,EASTERN REGION,0,0,0,2,2
30/03/2016,EASTERN REGION,1,1,0,2,4
31/03/2016,EASTERN REGION,0,1,0,0,1
1/04/2016,EASTERN REGION,0,1,0,0,1
2/04/2016,EASTERN REGION,0,0,0,2,2
3/04/2016,EASTERN REGION,0,2,0,3,5
4/04/2016,EASTERN REGION,0,1,0,0,1
5/04/2016,EASTERN REGION,0,2,0,1,3
6/04/2016,EASTERN REGION,0,0,0,3,3
7/04/2016,EASTERN REGION,0,1,0,3,4
8/04/2016,EASTERN REGION,0,1,0,1,2
9/04/2016,EASTERN REGION,0,3,0,2,5
10/04/2016,EASTERN REGION,0,0,0,0,0
11/04/2016,EASTERN REGION,0,0,0,1,1
12/04/2016,EASTERN REGION,0,0,0,1,1
13/04/2016,EASTERN REGION,0,0,0,0,0
14/04/2016,EASTERN REGION,0,2,0,2,4
15/04/2016,EASTERN REGION,0,0,0,4,4
16/04/2016,EASTERN REGION,0,1,0,3,4
17/04/2016,EASTERN REGION,0,4,0,1,5
18/04/2016,EASTERN REGION,0,0,0,0,0
19/04/2016,EASTERN REGION,0,2,0,3,5
20/04/2016,EASTERN REGION,0,1,0,2,3
21/04/2016,EASTERN REGION,0,1,0,0,1
22/04/2016,EASTERN REGION,0,0,0,2,2
23/04/2016,EASTERN REGION,0,1,0,3,4
24/04/2016,EASTERN REGION,0,3,0,5,8
25/04/2016,EASTERN REGION,0,1,0,2,3
26/04/2016,EASTERN REGION,0,0,0,2,2
27/04/2016,EASTERN REGION,0,0,0,4,4
28/04/2016,EASTERN REGION,0,3,0,1,4
29/04/2016,EASTERN REGION,0,1,0,2,3
30/04/2016,EASTERN REGION,0,2,0,1,3
1/05/2016,EASTERN REGION,0,0,0,2,2
2/05/2016,EASTERN REGION,0,1,0,1,2
3/05/2016,EASTERN REGION,0,1,0,4,5
4/05/2016,EASTERN REGION,0,0,0,0,0
5/05/2016,EASTERN REGION,0,0,0,4,4
6/05/2016,EASTERN REGION,0,0,0,0,0
7/05/2016,EASTERN REGION,0,1,0,4,5
8/05/2016,EASTERN REGION,0,0,0,2,2
9/05/2016,EASTERN REGION,0,0,0,3,3
10/05/2016,EASTERN REGION,0,1,0,3,4
11/05/2016,EASTERN REGION,0,1,0,2,3
12/05/2016,EASTERN REGION,0,0,0,3,3
13/05/2016,EASTERN REGION,0,0,0,2,2
14/05/2016,EASTERN REGION,0,1,0,4,5
15/05/2016,EASTERN REGION,0,3,0,2,5
16/05/2016,EASTERN REGION,0,1,0,2,3
17/05/2016,EASTERN REGION,0,1,0,1,2
18/05/2016,EASTERN REGION,0,2,0,2,4
19/05/2016,EASTERN REGION,0,1,0,2,3
20/05/2016,EASTERN REGION,0,0,0,1,1
21/05/2016,EASTERN REGION,0,5,0,3,8
22/05/2016,EASTERN REGION,0,0,0,1,1
23/05/2016,EASTERN REGION,0,2,0,4,6
24/05/2016,EASTERN REGION,0,0,0,0,0
25/05/2016,EASTERN REGION,0,0,0,2,2
26/05/2016,EASTERN REGION,0,2,0,4,6
27/05/2016,EASTERN REGION,0,1,0,0,1
28/05/2016,EASTERN REGION,0,1,0,1,2
29/05/2016,EASTERN REGION,0,0,0,0,0
30/05/2016,EASTERN REGION,0,1,0,0,1
31/05/2016,EASTERN REGION,0,1,0,2,3
1/06/2016,EASTERN REGION,0,0,0,1,1
2/06/2016,EASTERN REGION,0,1,0,0,1
3/06/2016,EASTERN REGION,0,1,0,3,4
4/06/2016,EASTERN REGION,0,0,0,4,4
5/06/2016,EASTERN REGION,0,0,0,3,3
6/06/2016,EASTERN REGION,1,1,0,1,3
7/06/2016,EASTERN REGION,0,0,0,1,1
8/06/2016,EASTERN REGION,0,1,0,0,1
9/06/2016,EASTERN REGION,0,0,0,3,3
10/06/2016,EASTERN REGION,1,0,0,3,4
11/06/2016,EASTERN REGION,1,1,0,1,3
12/06/2016,EASTERN REGION,0,0,0,5,5
13/06/2016,EASTERN REGION,0,2,0,1,3
14/06/2016,EASTERN REGION,0,1,0,0,1
15/06/2016,EASTERN REGION,0,1,0,2,3
16/06/2016,EASTERN REGION,0,1,0,3,4
17/06/2016,EASTERN REGION,0,1,0,4,5
18/06/2016,EASTERN REGION,0,2,0,2,4
19/06/2016,EASTERN REGION,0,1,0,0,1
20/06/2016,EASTERN REGION,0,0,0,3,3
21/06/2016,EASTERN REGION,0,0,0,1,1
22/06/2016,EASTERN REGION,0,0,0,1,1
23/06/2016,EASTERN REGION,0,0,0,1,1
24/06/2016,EASTERN REGION,0,1,0,3,4
25/06/2016,EASTERN REGION,0,2,0,4,6
26/06/2016,EASTERN REGION,0,3,0,2,5
27/06/2016,EASTERN REGION,0,1,0,1,2
28/06/2016,EASTERN REGION,0,0,0,0,0
29/06/2016,EASTERN REGION,0,1,0,3,4
30/06/2016,EASTERN REGION,0,0,0,1,1
1/07/2016,EASTERN REGION,0,1,0,2,3
2/07/2016,EASTERN REGION,0,1,0,1,2
3/07/2016,EASTERN REGION,0,2,0,2,4
4/07/2016,EASTERN REGION,0,0,0,0,0
5/07/2016,EASTERN REGION,0,1,0,3,4
6/07/2016,EASTERN REGION,0,0,0,3,3
7/07/2016,EASTERN REGION,0,2,0,2,4
8/07/2016,EASTERN REGION,0,1,0,1,2
9/07/2016,EASTERN REGION,0,3,0,1,4
10/07/2016,EASTERN REGION,0,0,0,1,1
11/07/2016,EASTERN REGION,0,1,0,3,4
12/07/2016,EASTERN REGION,0,0,0,1,1
13/07/2016,EASTERN REGION,0,1,0,4,5
14/07/2016,EASTERN REGION,0,1,0,4,5
15/07/2016,EASTERN REGION,0,1,0,2,3
16/07/2016,EASTERN REGION,1,4,0,2,7
17/07/2016,EASTERN REGION,0,2,0,2,4
18/07/2016,EASTERN REGION,0,1,0,3,4
19/07/2016,EASTERN REGION,0,1,0,1,2
20/07/2016,EASTERN REGION,0,2,0,2,4
21/07/2016,EASTERN REGION,0,0,0,1,1
22/07/2016,EASTERN REGION,0,0,0,0,0
23/07/2016,EASTERN REGION,1,2,0,1,4
24/07/2016,EASTERN REGION,1,2,0,4,7
25/07/2016,EASTERN REGION,0,2,0,4,6
26/07/2016,EASTERN REGION,0,0,0,0,0
27/07/2016,EASTERN REGION,1,0,0,1,2
28/07/2016,EASTERN REGION,0,1,0,2,3
29/07/2016,EASTERN REGION,0,1,0,1,2
30/07/2016,EASTERN REGION,0,0,0,3,3
31/07/2016,EASTERN REGION,0,3,0,1,4
1/08/2016,EASTERN REGION,0,2,0,1,3
2/08/2016,EASTERN REGION,0,1,0,0,1
3/08/2016,EASTERN REGION,0,1,0,1,2
4/08/2016,EASTERN REGION,0,1,0,2,3
5/08/2016,EASTERN REGION,0,1,0,0,1
6/08/2016,EASTERN REGION,0,2,0,1,3
7/08/2016,EASTERN REGION,0,0,0,2,2
8/08/2016,EASTERN REGION,0,0,0,2,2
9/08/2016,EASTERN REGION,0,0,0,1,1
10/08/2016,EASTERN REGION,0,0,0,0,0
11/08/2016,EASTERN REGION,0,0,0,1,1
12/08/2016,EASTERN REGION,0,1,0,1,2
13/08/2016,EASTERN REGION,0,2,0,5,7
14/08/2016,EASTERN REGION,0,1,0,2,3
15/08/2016,EASTERN REGION,0,1,0,0,1
16/08/2016,EASTERN REGION,0,1,0,2,3
17/08/2016,EASTERN REGION,0,0,0,3,3
18/08/2016,EASTERN REGION,0,2,0,1,3
19/08/2016,EASTERN REGION,0,1,0,2,3
20/08/2016,EASTERN REGION,0,0,0,2,2
21/08/2016,EASTERN REGION,0,2,0,4,6
22/08/2016,EASTERN REGION,1,0,0,1,2
23/08/2016,EASTERN REGION,0,0,0,2,2
24/08/2016,EASTERN REGION,0,0,0,1,1
25/08/2016,EASTERN REGION,0,3,0,2,5
26/08/2016,EASTERN REGION,0,1,0,4,5
27/08/2016,EASTERN REGION,0,1,0,2,3
28/08/2016,EASTERN REGION,0,0,0,4,4
29/08/2016,EASTERN REGION,0,1,0,1,2
30/08/2016,EASTERN REGION,0,1,0,1,2
31/08/2016,EASTERN REGION,0,1,0,0,1
1/09/2016,EASTERN REGION,0,2,0,2,4
2/09/2016,EASTERN REGION,0,0,0,0,0
3/09/2016,EASTERN REGION,0,1,0,3,4
4/09/2016,EASTERN REGION,0,0,0,0,0
5/09/2016,EASTERN REGION,0,0,0,2,2
6/09/2016,EASTERN REGION,0,0,0,2,2
7/09/2016,EASTERN REGION,0,1,0,1,2
8/09/2016,EASTERN REGION,0,1,0,0,1
9/09/2016,EASTERN REGION,2,0,0,3,5
10/09/2016,EASTERN REGION,0,1,0,2,3
11/09/2016,EASTERN REGION,0,2,0,1,3
12/09/2016,EASTERN REGION,0,1,0,2,3
13/09/2016,EASTERN REGION,0,0,0,0,0
14/09/2016,EASTERN REGION,0,1,0,1,2
15/09/2016,EASTERN REGION,0,1,0,0,1
16/09/2016,EASTERN REGION,0,2,0,0,2
17/09/2016,EASTERN REGION,0,0,0,2,2
18/09/2016,EASTERN REGION,0,2,0,4,6
19/09/2016,EASTERN REGION,0,0,0,0,0
20/09/2016,EASTERN REGION,0,0,0,0,0
21/09/2016,EASTERN REGION,0,0,0,2,2
22/09/2016,EASTERN REGION,0,0,0,2,2
23/09/2016,EASTERN REGION,0,1,0,2,3
24/09/2016,EASTERN REGION,0,1,0,3,4
25/09/2016,EASTERN REGION,0,2,0,0,2
26/09/2016,EASTERN REGION,0,0,0,1,1
27/09/2016,EASTERN REGION,0,2,0,2,4
28/09/2016,EASTERN REGION,0,1,0,2,3
29/09/2016,EASTERN REGION,0,0,0,2,2
30/09/2016,EASTERN REGION,0,1,0,1,2
1/10/2016,EASTERN REGION,0,3,0,1,4
2/10/2016,EASTERN REGION,0,2,0,3,5
3/10/2016,EASTERN REGION,0,3,0,3,6
4/10/2016,EASTERN REGION,0,0,0,1,1
5/10/2016,EASTERN REGION,0,0,0,5,5
6/10/2016,EASTERN REGION,0,1,0,0,1
7/10/2016,EASTERN REGION,0,1,0,2,3
8/10/2016,EASTERN REGION,0,3,0,3,6
9/10/2016,EASTERN REGION,0,1,0,2,3
10/10/2016,EASTERN REGION,0,1,0,2,3
11/10/2016,EASTERN REGION,0,1,0,0,1
12/10/2016,EASTERN REGION,0,1,0,0,1
13/10/2016,EASTERN REGION,0,0,0,1,1
14/10/2016,EASTERN REGION,0,0,0,4,4
15/10/2016,EASTERN REGION,0,1,0,2,3
16/10/2016,EASTERN REGION,0,0,0,5,5
17/10/2016,EASTERN REGION,0,0,0,1,1
18/10/2016,EASTERN REGION,0,0,0,5,5
19/10/2016,EASTERN REGION,0,2,0,0,2
20/10/2016,EASTERN REGION,0,3,0,0,3
21/10/2016,EASTERN REGION,0,1,0,0,1
22/10/2016,EASTERN REGION,0,1,0,3,4
23/10/2016,EASTERN REGION,0,0,0,2,2
24/10/2016,EASTERN REGION,0,1,0,4,5
25/10/2016,EASTERN REGION,1,0,0,1,2
26/10/2016,EASTERN REGION,0,0,0,0,0
27/10/2016,EASTERN REGION,0,0,0,0,0
28/10/2016,EASTERN REGION,0,0,0,3,3
29/10/2016,EASTERN REGION,0,2,0,1,3
30/10/2016,EASTERN REGION,0,2,0,5,7
31/10/2016,EASTERN REGION,1,3,0,2,6
1/11/2016,EASTERN REGION,0,3,0,2,5
2/11/2016,EASTERN REGION,0,1,0,0,1
3/11/2016,EASTERN REGION,0,1,0,0,1
4/11/2016,EASTERN REGION,0,2,0,1,3
5/11/2016,EASTERN REGION,0,0,0,3,3
6/11/2016,EASTERN REGION,0,3,0,1,4
7/11/2016,EASTERN REGION,0,0,0,0,0
8/11/2016,EASTERN REGION,0,2,0,2,4
9/11/2016,EASTERN REGION,0,0,0,1,1
10/11/2016,EASTERN REGION,0,1,0,3,4
11/11/2016,EASTERN REGION,0,0,0,0,0
12/11/2016,EASTERN REGION,1,4,0,3,8
13/11/2016,EASTERN REGION,0,0,0,2,2
14/11/2016,EASTERN REGION,0,1,0,1,2
15/11/2016,EASTERN REGION,0,0,0,2,2
16/11/2016,EASTERN REGION,0,1,0,1,2
17/11/2016,EASTERN REGION,0,0,0,2,2
18/11/2016,EASTERN REGION,0,0,0,1,1
19/11/2016,EASTERN REGION,0,1,0,3,4
20/11/2016,EASTERN REGION,1,2,0,3,6
21/11/2016,EASTERN REGION,0,1,0,3,4
22/11/2016,EASTERN REGION,1,1,0,2,4
23/11/2016,EASTERN REGION,0,0,0,1,1
24/11/2016,EASTERN REGION,0,0,0,0,0
25/11/2016,EASTERN REGION,0,0,0,2,2
26/11/2016,EASTERN REGION,0,2,0,4,6
27/11/2016,EASTERN REGION,0,2,0,0,2
28/11/2016,EASTERN REGION,0,0,0,2,2
29/11/2016,EASTERN REGION,0,0,0,2,2
30/11/2016,EASTERN REGION,0,1,0,2,3
1/12/2016,EASTERN REGION,0,1,0,1,2
2/12/2016,EASTERN REGION,1,2,0,0,3
3/12/2016,EASTERN REGION,0,2,0,0,2
4/12/2016,EASTERN REGION,0,2,0,4,6
5/12/2016,EASTERN REGION,0,0,0,2,2
6/12/2016,EASTERN REGION,0,2,0,0,2
7/12/2016,EASTERN REGION,0,0,0,2,2
8/12/2016,EASTERN REGION,0,1,0,3,4
9/12/2016,EASTERN REGION,0,0,0,3,3
10/12/2016,EASTERN REGION,0,1,0,3,4
11/12/2016,EASTERN REGION,0,4,0,3,7
12/12/2016,EASTERN REGION,0,0,0,2,2
13/12/2016,EASTERN REGION,0,1,0,0,1
14/12/2016,EASTERN REGION,0,0,0,1,1
15/12/2016,EASTERN REGION,0,1,0,0,1
16/12/2016,EASTERN REGION,0,1,0,2,3
17/12/2016,EASTERN REGION,1,0,0,2,3
18/12/2016,EASTERN REGION,0,1,0,1,2
19/12/2016,EASTERN REGION,0,2,0,5,7
20/12/2016,EASTERN REGION,0,0,0,0,0
21/12/2016,EASTERN REGION,0,0,0,1,1
22/12/2016,EASTERN REGION,0,1,0,0,1
23/12/2016,EASTERN REGION,0,1,0,2,3
24/12/2016,EASTERN REGION,0,1,0,1,2
25/12/2016,EASTERN REGION,0,0,0,3,3
26/12/2016,EASTERN REGION,0,1,0,1,2
27/12/2016,EASTERN REGION,0,1,0,1,2
28/12/2016,EASTERN REGION,0,1,0,5,6
29/12/2016,EASTERN REGION,0,1,0,0,1
30/12/2016,EASTERN REGION,0,1,0,3,4
31/12/2016,EASTERN REGION,0,0,0,0,0
1/01/2017,EASTERN REGION,0,0,0,2,2
2/01/2017,EASTERN REGION,1,0,0,2,3
3/01/2017,EASTERN REGION,0,3,0,2,5
4/01/2017,EASTERN REGION,0,0,0,2,2
5/01/2017,EASTERN REGION,1,1,0,0,2
6/01/2017,EASTERN REGION,0,1,0,3,4
7/01/2017,EASTERN REGION,0,0,0,1,1
8/01/2017,EASTERN REGION,0,2,0,1,3
9/01/2017,EASTERN REGION,0,0,0,1,1
10/01/2017,EASTERN REGION,0,0,0,2,2
11/01/2017,EASTERN REGION,0,1,0,2,3
12/01/2017,EASTERN REGION,0,3,0,1,4
13/01/2017,EASTERN REGION,0,0,0,2,2
14/01/2017,EASTERN REGION,0,0,0,2,2
15/01/2017,EASTERN REGION,0,2,0,2,4
16/01/2017,EASTERN REGION,0,0,0,0,0
17/01/2017,EASTERN REGION,2,2,0,0,4
18/01/2017,EASTERN REGION,0,1,0,0,1
19/01/2017,EASTERN REGION,0,0,0,1,1
20/01/2017,EASTERN REGION,0,1,0,1,2
21/01/2017,EASTERN REGION,0,1,0,3,4
22/01/2017,EASTERN REGION,1,2,0,1,4
23/01/2017,EASTERN REGION,0,2,0,3,5
24/01/2017,EASTERN REGION,0,0,0,1,1
25/01/2017,EASTERN REGION,0,1,0,2,3
26/01/2017,EASTERN REGION,0,2,0,1,3
27/01/2017,EASTERN REGION,0,0,0,1,1
28/01/2017,EASTERN REGION,0,1,0,0,1
29/01/2017,EASTERN REGION,0,1,0,0,1
30/01/2017,EASTERN REGION,0,1,0,1,2
31/01/2017,EASTERN REGION,0,0,0,0,0
1/02/2017,EASTERN REGION,0,2,0,1,3
2/02/2017,EASTERN REGION,0,0,0,0,0
3/02/2017,EASTERN REGION,0,0,0,0,0
4/02/2017,EASTERN REGION,0,0,0,1,1
5/02/2017,EASTERN REGION,0,1,0,1,2
6/02/2017,EASTERN REGION,0,1,0,0,1
7/02/2017,EASTERN REGION,1,0,0,0,1
8/02/2017,EASTERN REGION,0,0,0,2,2
9/02/2017,EASTERN REGION,0,0,0,1,1
10/02/2017,EASTERN REGION,0,1,0,1,2
11/02/2017,EASTERN REGION,0,0,0,0,0
12/02/2017,EASTERN REGION,0,1,0,1,2
13/02/2017,EASTERN REGION,0,2,0,4,6
14/02/2017,EASTERN REGION,0,0,0,0,0
15/02/2017,EASTERN REGION,0,1,0,1,2
16/02/2017,EASTERN REGION,0,0,0,1,1
17/02/2017,EASTERN REGION,0,3,0,1,4
18/02/2017,EASTERN REGION,0,1,0,2,3
19/02/2017,EASTERN REGION,0,3,0,1,4
20/02/2017,EASTERN REGION,0,0,0,1,1
21/02/2017,EASTERN REGION,0,0,0,2,2
22/02/2017,EASTERN REGION,0,1,0,1,2
23/02/2017,EASTERN REGION,1,1,0,2,4
24/02/2017,EASTERN REGION,0,2,0,1,3
25/02/2017,EASTERN REGION,0,1,0,1,2
26/02/2017,EASTERN REGION,0,2,0,0,2
27/02/2017,EASTERN REGION,0,1,0,1,2
28/02/2017,EASTERN REGION,0,0,0,0,0
1/03/2017,EASTERN REGION,0,0,0,0,0
2/03/2017,EASTERN REGION,0,2,0,3,5
3/03/2017,EASTERN REGION,0,1,0,1,2
4/03/2017,EASTERN REGION,0,2,0,5,7
5/03/2017,EASTERN REGION,0,0,0,2,2
6/03/2017,EASTERN REGION,0,3,0,2,5
7/03/2017,EASTERN REGION,0,0,0,0,0
8/03/2017,EASTERN REGION,0,0,0,0,0
9/03/2017,EASTERN REGION,0,0,0,0,0
10/03/2017,EASTERN REGION,0,0,0,0,0
11/03/2017,EASTERN REGION,1,2,0,0,3
12/03/2017,EASTERN REGION,0,0,0,1,1
13/03/2017,EASTERN REGION,0,3,0,2,5
14/03/2017,EASTERN REGION,0,1,0,0,1
15/03/2017,EASTERN REGION,0,0,0,1,1
16/03/2017,EASTERN REGION,0,2,0,5,7
17/03/2017,EASTERN REGION,0,0,0,3,3
18/03/2017,EASTERN REGION,0,0,0,3,3
19/03/2017,EASTERN REGION,0,0,0,1,1
20/03/2017,EASTERN REGION,0,2,0,1,3
21/03/2017,EASTERN REGION,0,0,0,2,2
22/03/2017,EASTERN REGION,0,2,0,2,4
23/03/2017,EASTERN REGION,0,1,0,0,1
24/03/2017,EASTERN REGION,0,2,0,2,4
25/03/2017,EASTERN REGION,1,2,0,2,5
26/03/2017,EASTERN REGION,0,1,0,3,4
27/03/2017,EASTERN REGION,0,3,0,2,5
28/03/2017,EASTERN REGION,0,0,0,1,1
29/03/2017,EASTERN REGION,0,2,0,0,2
30/03/2017,EASTERN REGION,0,2,0,0,2
31/03/2017,EASTERN REGION,0,0,0,3,3
1/04/2017,EASTERN REGION,0,4,0,1,5
2/04/2017,EASTERN REGION,0,0,0,1,1
3/04/2017,EASTERN REGION,0,1,0,2,3
4/04/2017,EASTERN REGION,0,1,0,2,3
5/04/2017,EASTERN REGION,0,0,0,2,2
6/04/2017,EASTERN REGION,0,0,0,0,0
7/04/2017,EASTERN REGION,0,2,0,2,4
8/04/2017,EASTERN REGION,0,0,0,0,0
9/04/2017,EASTERN REGION,0,0,0,1,1
10/04/2017,EASTERN REGION,0,1,0,1,2
11/04/2017,EASTERN REGION,0,0,0,0,0
12/04/2017,EASTERN REGION,0,3,0,1,4
13/04/2017,EASTERN REGION,0,0,0,1,1
14/04/2017,EASTERN REGION,0,3,0,4,7
15/04/2017,EASTERN REGION,0,1,0,1,2
16/04/2017,EASTERN REGION,0,0,0,0,0
17/04/2017,EASTERN REGION,0,0,0,2,2
18/04/2017,EASTERN REGION,1,1,0,2,4
19/04/2017,EASTERN REGION,1,0,0,2,3
20/04/2017,EASTERN REGION,0,0,0,0,0
21/04/2017,EASTERN REGION,0,1,0,3,4
22/04/2017,EASTERN REGION,0,1,0,0,1
23/04/2017,EASTERN REGION,1,2,0,2,5
24/04/2017,EASTERN REGION,0,1,0,0,1
25/04/2017,EASTERN REGION,0,2,0,5,7
26/04/2017,EASTERN REGION,0,1,0,4,5
27/04/2017,EASTERN REGION,0,0,0,1,1
28/04/2017,EASTERN REGION,0,0,0,1,1
29/04/2017,EASTERN REGION,0,2,0,0,2
30/04/2017,EASTERN REGION,0,2,0,1,3
1/05/2017,EASTERN REGION,0,2,0,2,4
2/05/2017,EASTERN REGION,1,1,0,1,3
3/05/2017,EASTERN REGION,0,0,0,3,3
4/05/2017,EASTERN REGION,0,0,0,1,1
5/05/2017,EASTERN REGION,0,1,0,0,1
6/05/2017,EASTERN REGION,0,0,0,4,4
7/05/2017,EASTERN REGION,0,1,0,0,1
8/05/2017,EASTERN REGION,0,1,0,2,3
9/05/2017,EASTERN REGION,0,0,0,1,1
10/05/2017,EASTERN REGION,0,2,0,0,2
11/05/2017,EASTERN REGION,0,1,0,1,2
12/05/2017,EASTERN REGION,0,0,0,1,1
13/05/2017,EASTERN REGION,0,1,0,0,1
14/05/2017,EASTERN REGION,0,0,0,1,1
15/05/2017,EASTERN REGION,1,0,0,1,2
16/05/2017,EASTERN REGION,0,0,0,1,1
17/05/2017,EASTERN REGION,1,0,0,0,1
18/05/2017,EASTERN REGION,0,1,0,0,1
19/05/2017,EASTERN REGION,1,2,0,3,6
20/05/2017,EASTERN REGION,0,1,0,4,5
21/05/2017,EASTERN REGION,0,1,0,2,3
22/05/2017,EASTERN REGION,0,1,0,0,1
23/05/2017,EASTERN REGION,0,1,0,1,2
24/05/2017,EASTERN REGION,0,0,0,2,2
25/05/2017,EASTERN REGION,0,1,0,0,1
26/05/2017,EASTERN REGION,0,0,0,1,1
27/05/2017,EASTERN REGION,0,1,0,1,2
28/05/2017,EASTERN REGION,0,1,0,1,2
29/05/2017,EASTERN REGION,0,0,0,1,1
30/05/2017,EASTERN REGION,0,0,0,0,0
31/05/2017,EASTERN REGION,0,0,0,2,2
1/06/2017,EASTERN REGION,0,0,0,1,1
2/06/2017,EASTERN REGION,0,1,0,1,2
3/06/2017,EASTERN REGION,0,1,0,0,1
4/06/2017,EASTERN REGION,0,0,0,1,1
5/06/2017,EASTERN REGION,0,2,0,1,3
6/06/2017,EASTERN REGION,0,0,0,1,1
7/06/2017,EASTERN REGION,0,1,0,0,1
8/06/2017,EASTERN REGION,0,0,0,1,1
9/06/2017,EASTERN REGION,0,0,0,1,1
10/06/2017,EASTERN REGION,0,3,0,3,6
11/06/2017,EASTERN REGION,0,0,0,1,1
12/06/2017,EASTERN REGION,0,1,0,2,3
13/06/2017,EASTERN REGION,0,0,0,2,2
14/06/2017,EASTERN REGION,0,0,0,1,1
15/06/2017,EASTERN REGION,0,0,0,3,3
16/06/2017,EASTERN REGION,0,0,0,1,1
17/06/2017,EASTERN REGION,0,0,0,2,2
18/06/2017,EASTERN REGION,2,0,0,2,4
19/06/2017,EASTERN REGION,0,1,0,2,3
20/06/2017,EASTERN REGION,0,1,0,2,3
21/06/2017,EASTERN REGION,0,0,0,1,1
22/06/2017,EASTERN REGION,0,1,0,0,1
23/06/2017,EASTERN REGION,0,0,0,1,1
24/06/2017,EASTERN REGION,0,0,0,0,0
25/06/2017,EASTERN REGION,0,2,0,1,3
26/06/2017,EASTERN REGION,0,1,0,0,1
27/06/2017,EASTERN REGION,0,0,0,0,0
28/06/2017,EASTERN REGION,0,0,0,0,0
29/06/2017,EASTERN REGION,1,0,0,2,3
30/06/2017,EASTERN REGION,0,0,0,0,0
1/07/2017,EASTERN REGION,0,1,0,0,1
2/07/2017,EASTERN REGION,0,3,0,0,3
3/07/2017,EASTERN REGION,0,0,0,1,1
4/07/2017,EASTERN REGION,0,0,0,1,1
5/07/2017,EASTERN REGION,0,0,0,1,1
6/07/2017,EASTERN REGION,0,1,0,1,2
7/07/2017,EASTERN REGION,0,0,0,0,0
8/07/2017,EASTERN REGION,0,0,0,1,1
9/07/2017,EASTERN REGION,0,1,0,2,3
10/07/2017,EASTERN REGION,0,0,0,0,0
11/07/2017,EASTERN REGION,0,1,0,1,2
12/07/2017,EASTERN REGION,0,0,0,1,1
13/07/2017,EASTERN REGION,0,0,0,0,0
14/07/2017,EASTERN REGION,0,0,0,3,3
15/07/2017,EASTERN REGION,0,0,0,1,1
16/07/2017,EASTERN REGION,1,1,0,0,2
17/07/2017,EASTERN REGION,0,0,0,2,2
18/07/2017,EASTERN REGION,0,0,0,1,1
19/07/2017,EASTERN REGION,0,0,0,0,0
20/07/2017,EASTERN REGION,0,2,0,1,3
21/07/2017,EASTERN REGION,0,1,0,2,3
22/07/2017,EASTERN REGION,1,0,0,1,2
23/07/2017,EASTERN REGION,0,0,0,0,0
24/07/2017,EASTERN REGION,0,0,0,0,0
25/07/2017,EASTERN REGION,0,1,0,1,2
26/07/2017,EASTERN REGION,0,1,0,2,3
27/07/2017,EASTERN REGION,0,0,0,2,2
28/07/2017,EASTERN REGION,0,1,0,1,2
29/07/2017,EASTERN REGION,0,0,0,1,1
30/07/2017,EASTERN REGION,0,0,0,2,2
31/07/2017,EASTERN REGION,0,0,0,1,1
1/08/2017,EASTERN REGION,0,0,0,1,1
2/08/2017,EASTERN REGION,0,1,0,2,3
3/08/2017,EASTERN REGION,0,0,0,0,0
4/08/2017,EASTERN REGION,0,0,0,0,0
5/08/2017,EASTERN REGION,2,0,0,2,4
6/08/2017,EASTERN REGION,0,1,0,2,3
7/08/2017,EASTERN REGION,0,0,0,1,1
8/08/2017,EASTERN REGION,0,1,0,2,3
9/08/2017,EASTERN REGION,0,1,0,1,2
10/08/2017,EASTERN REGION,0,0,0,1,1
11/08/2017,EASTERN REGION,0,1,0,2,3
12/08/2017,EASTERN REGION,0,1,0,0,1
13/08/2017,EASTERN REGION,0,0,0,2,2
14/08/2017,EASTERN REGION,0,0,0,0,0
15/08/2017,EASTERN REGION,0,1,0,1,2
16/08/2017,EASTERN REGION,0,1,0,2,3
17/08/2017,EASTERN REGION,0,1,0,0,1
18/08/2017,EASTERN REGION,0,2,0,2,4
19/08/2017,EASTERN REGION,0,1,0,1,2
20/08/2017,EASTERN REGION,0,2,0,1,3
21/08/2017,EASTERN REGION,0,1,0,0,1
22/08/2017,EASTERN REGION,0,0,0,1,1
23/08/2017,EASTERN REGION,0,0,0,0,0
24/08/2017,EASTERN REGION,0,3,0,0,3
25/08/2017,EASTERN REGION,0,1,0,2,3
26/08/2017,EASTERN REGION,0,1,0,3,4
27/08/2017,EASTERN REGION,0,0,0,2,2
28/08/2017,EASTERN REGION,0,1,0,0,1
29/08/2017,EASTERN REGION,0,1,0,0,1
30/08/2017,EASTERN REGION,0,0,0,3,3
31/08/2017,EASTERN REGION,0,0,0,3,3
1/09/2017,EASTERN REGION,0,1,0,1,2
2/09/2017,EASTERN REGION,0,0,0,2,2
3/09/2017,EASTERN REGION,1,0,0,2,3
4/09/2017,EASTERN REGION,0,0,0,1,1
5/09/2017,EASTERN REGION,0,0,0,2,2
6/09/2017,EASTERN REGION,0,0,0,2,2
7/09/2017,EASTERN REGION,0,1,0,1,2
8/09/2017,EASTERN REGION,0,0,0,0,0
9/09/2017,EASTERN REGION,0,1,0,1,2
10/09/2017,EASTERN REGION,0,1,0,4,5
11/09/2017,EASTERN REGION,0,1,0,1,2
12/09/2017,EASTERN REGION,0,0,0,1,1
13/09/2017,EASTERN REGION,0,0,0,0,0
14/09/2017,EASTERN REGION,0,0,0,0,0
15/09/2017,EASTERN REGION,0,0,0,0,0
16/09/2017,EASTERN REGION,0,0,0,0,0
17/09/2017,EASTERN REGION,0,1,0,1,2
18/09/2017,EASTERN REGION,0,3,0,1,4
19/09/2017,EASTERN REGION,1,0,0,1,2
20/09/2017,EASTERN REGION,0,2,0,2,4
21/09/2017,EASTERN REGION,0,1,0,1,2
22/09/2017,EASTERN REGION,0,0,0,1,1
23/09/2017,EASTERN REGION,0,0,0,0,0
24/09/2017,EASTERN REGION,1,0,0,1,2
25/09/2017,EASTERN REGION,0,1,0,1,2
26/09/2017,EASTERN REGION,0,1,0,0,1
27/09/2017,EASTERN REGION,0,0,0,4,4
28/09/2017,EASTERN REGION,0,2,0,1,3
29/09/2017,EASTERN REGION,0,0,0,2,2
30/09/2017,EASTERN REGION,0,1,0,1,2
1/10/2017,EASTERN REGION,0,0,0,3,3
2/10/2017,EASTERN REGION,0,0,0,1,1
3/10/2017,EASTERN REGION,0,1,0,1,2
4/10/2017,EASTERN REGION,0,1,0,1,2
5/10/2017,EASTERN REGION,0,2,0,1,3
6/10/2017,EASTERN REGION,0,0,0,2,2
7/10/2017,EASTERN REGION,0,2,0,0,2
8/10/2017,EASTERN REGION,0,1,0,0,1
9/10/2017,EASTERN REGION,0,2,0,1,3
10/10/2017,EASTERN REGION,0,0,0,1,1
11/10/2017,EASTERN REGION,0,0,0,0,0
12/10/2017,EASTERN REGION,0,2,0,0,2
13/10/2017,EASTERN REGION,0,0,0,1,1
14/10/2017,EASTERN REGION,1,3,0,1,5
15/10/2017,EASTERN REGION,0,3,0,3,6
16/10/2017,EASTERN REGION,1,1,0,0,2
17/10/2017,EASTERN REGION,0,1,0,0,1
18/10/2017,EASTERN REGION,0,2,0,1,3
19/10/2017,EASTERN REGION,0,1,0,3,4
20/10/2017,EASTERN REGION,0,4,0,3,7
21/10/2017,EASTERN REGION,0,1,0,0,1
22/10/2017,EASTERN REGION,0,0,0,1,1
23/10/2017,EASTERN REGION,0,1,0,3,4
24/10/2017,EASTERN REGION,0,1,0,2,3
25/10/2017,EASTERN REGION,0,2,0,1,3
26/10/2017,EASTERN REGION,0,2,0,1,3
27/10/2017,EASTERN REGION,0,0,0,1,1
28/10/2017,EASTERN REGION,0,0,0,0,0
29/10/2017,EASTERN REGION,0,2,0,2,4
30/10/2017,EASTERN REGION,0,2,0,3,5
31/10/2017,EASTERN REGION,0,0,0,0,0
1/11/2017,EASTERN REGION,0,1,0,3,4
2/11/2017,EASTERN REGION,0,3,0,0,3
3/11/2017,EASTERN REGION,0,1,0,0,1
4/11/2017,EASTERN REGION,0,1,0,4,5
5/11/2017,EASTERN REGION,1,1,0,2,4
6/11/2017,EASTERN REGION,0,1,0,1,2
7/11/2017,EASTERN REGION,0,0,0,1,1
8/11/2017,EASTERN REGION,0,3,0,1,4
9/11/2017,EASTERN REGION,0,0,0,1,1
10/11/2017,EASTERN REGION,0,0,0,1,1
11/11/2017,EASTERN REGION,0,0,0,0,0
12/11/2017,EASTERN REGION,0,3,0,2,5
13/11/2017,EASTERN REGION,0,1,0,4,5
14/11/2017,EASTERN REGION,0,0,0,1,1
15/11/2017,EASTERN REGION,0,1,0,2,3
16/11/2017,EASTERN REGION,0,1,0,2,3
17/11/2017,EASTERN REGION,1,0,0,1,2
18/11/2017,EASTERN REGION,1,2,0,4,7
19/11/2017,EASTERN REGION,0,4,0,1,5
20/11/2017,EASTERN REGION,0,1,0,1,2
21/11/2017,EASTERN REGION,0,2,0,2,4
22/11/2017,EASTERN REGION,0,0,0,1,1
23/11/2017,EASTERN REGION,0,0,0,1,1
24/11/2017,EASTERN REGION,0,0,0,4,4
25/11/2017,EASTERN REGION,1,1,0,2,4
26/11/2017,EASTERN REGION,0,0,0,0,0
27/11/2017,EASTERN REGION,0,0,0,0,0
28/11/2017,EASTERN REGION,0,0,0,1,1
29/11/2017,EASTERN REGION,0,0,0,1,1
30/11/2017,EASTERN REGION,0,1,0,0,1
1/12/2017,EASTERN REGION,0,1,0,1,2
2/12/2017,EASTERN REGION,0,1,0,3,4
3/12/2017,EASTERN REGION,0,0,0,1,1
4/12/2017,EASTERN REGION,0,1,0,1,2
5/12/2017,EASTERN REGION,0,0,0,0,0
6/12/2017,EASTERN REGION,0,1,0,2,3
7/12/2017,EASTERN REGION,0,1,0,2,3
8/12/2017,EASTERN REGION,0,2,0,0,2
9/12/2017,EASTERN REGION,0,2,0,2,4
10/12/2017,EASTERN REGION,0,2,0,1,3
11/12/2017,EASTERN REGION,0,1,0,2,3
12/12/2017,EASTERN REGION,0,0,0,3,3
13/12/2017,EASTERN REGION,0,0,0,0,0
14/12/2017,EASTERN REGION,0,1,0,1,2
15/12/2017,EASTERN REGION,0,0,0,4,4
16/12/2017,EASTERN REGION,0,3,0,1,4
17/12/2017,EASTERN REGION,0,1,0,1,2
18/12/2017,EASTERN REGION,0,0,0,0,0
19/12/2017,EASTERN REGION,0,1,0,1,2
20/12/2017,EASTERN REGION,0,1,0,0,1
21/12/2017,EASTERN REGION,0,0,0,0,0
22/12/2017,EASTERN REGION,0,1,0,0,1
23/12/2017,EASTERN REGION,0,1,0,5,6
24/12/2017,EASTERN REGION,0,0,0,1,1
25/12/2017,EASTERN REGION,0,1,0,2,3
26/12/2017,EASTERN REGION,0,0,0,5,5
27/12/2017,EASTERN REGION,0,0,0,2,2
28/12/2017,EASTERN REGION,1,0,0,0,1
29/12/2017,EASTERN REGION,1,0,0,5,6
30/12/2017,EASTERN REGION,0,0,0,3,3
31/12/2017,EASTERN REGION,0,2,0,4,6
1/01/2018,EASTERN REGION,0,0,0,2,2
2/01/2018,EASTERN REGION,0,2,0,1,3
3/01/2018,EASTERN REGION,0,2,0,1,3
4/01/2018,EASTERN REGION,0,1,0,1,2
5/01/2018,EASTERN REGION,0,3,0,0,3
6/01/2018,EASTERN REGION,0,0,0,4,4
7/01/2018,EASTERN REGION,0,1,0,1,2
8/01/2018,EASTERN REGION,0,0,0,1,1
9/01/2018,EASTERN REGION,0,0,0,1,1
10/01/2018,EASTERN REGION,0,1,0,2,3
11/01/2018,EASTERN REGION,0,1,0,1,2
12/01/2018,EASTERN REGION,0,3,0,2,5
13/01/2018,EASTERN REGION,0,1,0,1,2
14/01/2018,EASTERN REGION,1,2,0,1,4
15/01/2018,EASTERN REGION,0,0,0,2,2
16/01/2018,EASTERN REGION,0,0,0,1,1
17/01/2018,EASTERN REGION,0,0,0,3,3
18/01/2018,EASTERN REGION,1,0,0,4,5
19/01/2018,EASTERN REGION,0,2,0,1,3
20/01/2018,EASTERN REGION,1,2,0,2,5
21/01/2018,EASTERN REGION,0,3,0,2,5
22/01/2018,EASTERN REGION,0,0,0,0,0
23/01/2018,EASTERN REGION,0,0,0,0,0
24/01/2018,EASTERN REGION,0,1,0,0,1
25/01/2018,EASTERN REGION,0,0,0,3,3
26/01/2018,EASTERN REGION,0,2,0,2,4
27/01/2018,EASTERN REGION,0,1,0,1,2
28/01/2018,EASTERN REGION,0,0,0,3,3
29/01/2018,EASTERN REGION,0,0,0,2,2
30/01/2018,EASTERN REGION,0,1,0,5,6
31/01/2018,EASTERN REGION,0,0,0,3,3
1/02/2018,EASTERN REGION,0,0,0,1,1
2/02/2018,EASTERN REGION,0,1,0,0,1
3/02/2018,EASTERN REGION,0,0,0,1,1
4/02/2018,EASTERN REGION,0,0,0,2,2
5/02/2018,EASTERN REGION,0,1,0,1,2
6/02/2018,EASTERN REGION,0,0,0,0,0
7/02/2018,EASTERN REGION,0,2,0,4,6
8/02/2018,EASTERN REGION,0,0,0,0,0
9/02/2018,EASTERN REGION,0,0,0,2,2
10/02/2018,EASTERN REGION,0,1,0,0,1
11/02/2018,EASTERN REGION,0,0,0,1,1
12/02/2018,EASTERN REGION,0,2,0,0,2
13/02/2018,EASTERN REGION,1,0,0,2,3
14/02/2018,EASTERN REGION,0,0,0,3,3
15/02/2018,EASTERN REGION,0,0,0,0,0
16/02/2018,EASTERN REGION,0,2,0,2,4
17/02/2018,EASTERN REGION,0,2,0,1,3
18/02/2018,EASTERN REGION,0,1,0,2,3
19/02/2018,EASTERN REGION,0,0,0,3,3
20/02/2018,EASTERN REGION,0,0,0,4,4
21/02/2018,EASTERN REGION,0,1,0,1,2
22/02/2018,EASTERN REGION,0,0,0,2,2
23/02/2018,EASTERN REGION,0,1,0,0,1
24/02/2018,EASTERN REGION,0,1,0,1,2
25/02/2018,EASTERN REGION,0,0,0,1,1
26/02/2018,EASTERN REGION,0,1,0,1,2
27/02/2018,EASTERN REGION,0,0,0,2,2
28/02/2018,EASTERN REGION,0,0,0,2,2
1/03/2018,EASTERN REGION,0,0,0,1,1
2/03/2018,EASTERN REGION,0,0,0,2,2
3/03/2018,EASTERN REGION,0,0,0,1,1
4/03/2018,EASTERN REGION,0,2,0,1,3
5/03/2018,EASTERN REGION,0,3,0,0,3
6/03/2018,EASTERN REGION,0,0,0,1,1
7/03/2018,EASTERN REGION,0,1,0,1,2
8/03/2018,EASTERN REGION,0,1,0,2,3
9/03/2018,EASTERN REGION,1,1,0,2,4
10/03/2018,EASTERN REGION,0,4,0,3,7
11/03/2018,EASTERN REGION,0,1,0,2,3
12/03/2018,EASTERN REGION,0,2,0,0,2
13/03/2018,EASTERN REGION,0,2,0,1,3
14/03/2018,EASTERN REGION,0,0,0,0,0
15/03/2018,EASTERN REGION,0,0,0,2,2
16/03/2018,EASTERN REGION,0,1,0,1,2
17/03/2018,EASTERN REGION,0,2,0,1,3
18/03/2018,EASTERN REGION,0,0,0,1,1
19/03/2018,EASTERN REGION,0,0,0,1,1
20/03/2018,EASTERN REGION,0,0,0,1,1
21/03/2018,EASTERN REGION,0,1,0,0,1
22/03/2018,EASTERN REGION,0,1,0,1,2
23/03/2018,EASTERN REGION,0,0,0,2,2
24/03/2018,EASTERN REGION,0,2,0,4,6
25/03/2018,EASTERN REGION,0,2,0,2,4
26/03/2018,EASTERN REGION,0,1,0,3,4
27/03/2018,EASTERN REGION,0,1,0,2,3
28/03/2018,EASTERN REGION,1,2,0,3,6
29/03/2018,EASTERN REGION,0,0,0,3,3
30/03/2018,EASTERN REGION,0,2,0,1,3
31/03/2018,EASTERN REGION,0,1,0,4,5
1/04/2018,EASTERN REGION,0,0,0,3,3
2/04/2018,EASTERN REGION,0,0,0,0,0
3/04/2018,EASTERN REGION,0,0,0,1,1
4/04/2018,EASTERN REGION,0,0,0,0,0
5/04/2018,EASTERN REGION,0,0,0,1,1
6/04/2018,EASTERN REGION,0,1,0,0,1
7/04/2018,EASTERN REGION,0,1,0,1,2
8/04/2018,EASTERN REGION,0,3,0,1,4
9/04/2018,EASTERN REGION,0,1,0,1,2
10/04/2018,EASTERN REGION,0,2,0,1,3
11/04/2018,EASTERN REGION,0,1,0,1,2
12/04/2018,EASTERN REGION,0,0,0,1,1
13/04/2018,EASTERN REGION,0,0,0,0,0
14/04/2018,EASTERN REGION,0,1,0,0,1
15/04/2018,EASTERN REGION,0,1,0,1,2
16/04/2018,EASTERN REGION,0,1,0,2,3
17/04/2018,EASTERN REGION,0,0,0,1,1
18/04/2018,EASTERN REGION,0,1,0,1,2
19/04/2018,EASTERN REGION,0,1,0,0,1
20/04/2018,EASTERN REGION,0,1,0,3,4
21/04/2018,EASTERN REGION,0,2,0,2,4
22/04/2018,EASTERN REGION,0,3,0,1,4
23/04/2018,EASTERN REGION,0,1,0,0,1
24/04/2018,EASTERN REGION,0,1,0,1,2
25/04/2018,EASTERN REGION,0,0,0,2,2
26/04/2018,EASTERN REGION,0,0,0,2,2
27/04/2018,EASTERN REGION,0,1,0,2,3
28/04/2018,EASTERN REGION,1,1,0,1,3
29/04/2018,EASTERN REGION,0,0,0,2,2
30/04/2018,EASTERN REGION,0,1,0,1,2
1/05/2018,EASTERN REGION,0,1,0,2,3
2/05/2018,EASTERN REGION,0,0,0,1,1
3/05/2018,EASTERN REGION,0,1,0,3,4
4/05/2018,EASTERN REGION,0,2,0,1,3
5/05/2018,EASTERN REGION,0,2,0,1,3
6/05/2018,EASTERN REGION,0,2,0,0,2
7/05/2018,EASTERN REGION,0,0,0,1,1
8/05/2018,EASTERN REGION,0,2,0,0,2
9/05/2018,EASTERN REGION,1,0,0,4,5
10/05/2018,EASTERN REGION,1,0,0,0,1
11/05/2018,EASTERN REGION,0,2,0,1,3
12/05/2018,EASTERN REGION,0,0,0,1,1
13/05/2018,EASTERN REGION,0,3,0,0,3
14/05/2018,EASTERN REGION,0,0,0,3,3
15/05/2018,EASTERN REGION,0,1,0,0,1
16/05/2018,EASTERN REGION,0,1,0,1,2
17/05/2018,EASTERN REGION,0,0,0,0,0
18/05/2018,EASTERN REGION,0,1,0,4,5
19/05/2018,EASTERN REGION,0,2,0,1,3
20/05/2018,EASTERN REGION,0,2,0,1,3
21/05/2018,EASTERN REGION,1,1,0,0,2
22/05/2018,EASTERN REGION,0,0,0,2,2
23/05/2018,EASTERN REGION,0,2,0,2,4
24/05/2018,EASTERN REGION,0,1,0,0,1
25/05/2018,EASTERN REGION,0,0,0,0,0
26/05/2018,EASTERN REGION,1,2,0,0,3
27/05/2018,EASTERN REGION,0,1,0,1,2
28/05/2018,EASTERN REGION,0,0,0,0,0
29/05/2018,EASTERN REGION,0,0,0,0,0
30/05/2018,EASTERN REGION,0,1,0,1,2
31/05/2018,EASTERN REGION,0,0,0,0,0
1/06/2018,EASTERN REGION,0,1,0,0,1
2/06/2018,EASTERN REGION,0,1,0,2,3
3/06/2018,EASTERN REGION,0,1,0,1,2
4/06/2018,EASTERN REGION,0,0,0,1,1
5/06/2018,EASTERN REGION,0,3,0,1,4
6/06/2018,EASTERN REGION,0,1,0,0,1
7/06/2018,EASTERN REGION,0,0,0,1,1
8/06/2018,EASTERN REGION,0,2,0,1,3
9/06/2018,EASTERN REGION,0,3,0,2,5
10/06/2018,EASTERN REGION,0,1,0,0,1
11/06/2018,EASTERN REGION,0,3,0,4,7
12/06/2018,EASTERN REGION,0,1,0,1,2
13/06/2018,EASTERN REGION,0,1,0,0,1
14/06/2018,EASTERN REGION,0,0,0,0,0
15/06/2018,EASTERN REGION,0,0,0,0,0
16/06/2018,EASTERN REGION,0,0,0,1,1
17/06/2018,EASTERN REGION,0,1,0,2,3
18/06/2018,EASTERN REGION,0,1,0,0,1
19/06/2018,EASTERN REGION,0,0,0,1,1
20/06/2018,EASTERN REGION,0,1,0,0,1
21/06/2018,EASTERN REGION,0,0,0,2,2
22/06/2018,EASTERN REGION,0,0,0,0,0
23/06/2018,EASTERN REGION,0,1,0,1,2
24/06/2018,EASTERN REGION,0,0,0,3,3
25/06/2018,EASTERN REGION,0,0,0,2,2
26/06/2018,EASTERN REGION,0,0,0,2,2
27/06/2018,EASTERN REGION,0,0,0,1,1
28/06/2018,EASTERN REGION,0,1,0,0,1
29/06/2018,EASTERN REGION,0,0,0,1,1
30/06/2018,EASTERN REGION,0,3,0,0,3
1/07/2018,EASTERN REGION,0,1,0,2,3
2/07/2018,EASTERN REGION,0,0,0,1,1
3/07/2018,EASTERN REGION,0,1,0,0,1
4/07/2018,EASTERN REGION,0,1,0,3,4
5/07/2018,EASTERN REGION,0,1,0,1,2
6/07/2018,EASTERN REGION,0,1,0,1,2
7/07/2018,EASTERN REGION,0,2,0,3,5
8/07/2018,EASTERN REGION,0,1,0,2,3
9/07/2018,EASTERN REGION,0,1,0,2,3
10/07/2018,EASTERN REGION,0,2,0,1,3
11/07/2018,EASTERN REGION,0,0,0,1,1
12/07/2018,EASTERN REGION,0,2,0,1,3
13/07/2018,EASTERN REGION,0,2,0,3,5
14/07/2018,EASTERN REGION,0,1,0,1,2
15/07/2018,EASTERN REGION,0,1,0,2,3
16/07/2018,EASTERN REGION,0,1,0,2,3
17/07/2018,EASTERN REGION,0,1,0,3,4
18/07/2018,EASTERN REGION,0,1,0,0,1
19/07/2018,EASTERN REGION,0,2,0,2,4
20/07/2018,EASTERN REGION,0,0,0,1,1
21/07/2018,EASTERN REGION,0,1,0,3,4
22/07/2018,EASTERN REGION,0,0,0,1,1
23/07/2018,EASTERN REGION,0,0,0,1,1
24/07/2018,EASTERN REGION,0,3,0,1,4
25/07/2018,EASTERN REGION,0,1,0,2,3
26/07/2018,EASTERN REGION,0,0,0,1,1
27/07/2018,EASTERN REGION,0,3,0,1,4
28/07/2018,EASTERN REGION,0,0,0,4,4
29/07/2018,EASTERN REGION,0,2,0,1,3
30/07/2018,EASTERN REGION,0,0,0,1,1
31/07/2018,EASTERN REGION,0,0,0,0,0
1/08/2018,EASTERN REGION,0,0,0,2,2
2/08/2018,EASTERN REGION,0,0,0,0,0
3/08/2018,EASTERN REGION,0,0,0,1,1
4/08/2018,EASTERN REGION,0,1,0,0,1
5/08/2018,EASTERN REGION,0,1,0,1,2
6/08/2018,EASTERN REGION,0,1,0,1,2
7/08/2018,EASTERN REGION,0,0,0,1,1
8/08/2018,EASTERN REGION,0,1,0,1,2
9/08/2018,EASTERN REGION,0,0,0,1,1
10/08/2018,EASTERN REGION,0,0,0,2,2
11/08/2018,EASTERN REGION,0,0,0,1,1
12/08/2018,EASTERN REGION,0,1,0,2,3
13/08/2018,EASTERN REGION,0,2,0,1,3
14/08/2018,EASTERN REGION,0,2,0,1,3
15/08/2018,EASTERN REGION,0,0,0,2,2
16/08/2018,EASTERN REGION,0,0,0,1,1
17/08/2018,EASTERN REGION,0,0,0,1,1
18/08/2018,EASTERN REGION,0,1,0,2,3
19/08/2018,EASTERN REGION,0,2,0,0,2
20/08/2018,EASTERN REGION,0,2,0,1,3
21/08/2018,EASTERN REGION,1,1,0,1,3
22/08/2018,EASTERN REGION,0,1,0,0,1
23/08/2018,EASTERN REGION,0,0,0,0,0
24/08/2018,EASTERN REGION,0,2,0,2,4
25/08/2018,EASTERN REGION,0,1,0,1,2
26/08/2018,EASTERN REGION,0,1,0,3,4
27/08/2018,EASTERN REGION,0,0,0,1,1
28/08/2018,EASTERN REGION,0,0,0,0,0
29/08/2018,EASTERN REGION,0,0,0,0,0
30/08/2018,EASTERN REGION,0,0,0,1,1
31/08/2018,EASTERN REGION,0,0,0,1,1
1/09/2018,EASTERN REGION,0,1,0,1,2
2/09/2018,EASTERN REGION,1,0,0,2,3
3/09/2018,EASTERN REGION,1,0,0,1,2
4/09/2018,EASTERN REGION,1,0,0,1,2
5/09/2018,EASTERN REGION,0,0,0,0,0
6/09/2018,EASTERN REGION,0,0,0,0,0
7/09/2018,EASTERN REGION,0,2,0,1,3
8/09/2018,EASTERN REGION,0,1,0,1,2
9/09/2018,EASTERN REGION,0,1,0,0,1
10/09/2018,EASTERN REGION,0,2,0,1,3
11/09/2018,EASTERN REGION,0,1,0,0,1
12/09/2018,EASTERN REGION,0,1,0,0,1
13/09/2018,EASTERN REGION,1,2,0,1,4
14/09/2018,EASTERN REGION,2,1,0,2,5
15/09/2018,EASTERN REGION,0,1,0,3,4
16/09/2018,EASTERN REGION,0,3,0,1,4
17/09/2018,EASTERN REGION,0,0,0,0,0
18/09/2018,EASTERN REGION,0,0,0,0,0
19/09/2018,EASTERN REGION,0,0,0,1,1
20/09/2018,EASTERN REGION,0,1,0,2,3
21/09/2018,EASTERN REGION,0,1,0,2,3
22/09/2018,EASTERN REGION,0,1,0,1,2
23/09/2018,EASTERN REGION,0,3,0,0,3
24/09/2018,EASTERN REGION,0,0,0,0,0
25/09/2018,EASTERN REGION,0,0,0,1,1
26/09/2018,EASTERN REGION,0,0,0,0,0
27/09/2018,EASTERN REGION,0,1,0,3,4
28/09/2018,EASTERN REGION,1,0,0,0,1
29/09/2018,EASTERN REGION,0,1,0,1,2
30/09/2018,EASTERN REGION,0,2,0,1,3
1/10/2018,EASTERN REGION,0,1,0,1,2
2/10/2018,EASTERN REGION,1,1,0,2,4
3/10/2018,EASTERN REGION,0,0,0,0,0
4/10/2018,EASTERN REGION,0,2,0,0,2
5/10/2018,EASTERN REGION,0,2,0,2,4
6/10/2018,EASTERN REGION,0,1,0,0,1
7/10/2018,EASTERN REGION,0,0,0,0,0
8/10/2018,EASTERN REGION,0,1,0,2,3
9/10/2018,EASTERN REGION,0,1,0,1,2
10/10/2018,EASTERN REGION,0,0,0,0,0
11/10/2018,EASTERN REGION,0,0,0,1,1
12/10/2018,EASTERN REGION,0,1,0,0,1
13/10/2018,EASTERN REGION,0,2,0,1,3
14/10/2018,EASTERN REGION,0,2,0,3,5
15/10/2018,EASTERN REGION,1,1,0,1,3
16/10/2018,EASTERN REGION,0,2,0,2,4
17/10/2018,EASTERN REGION,0,2,0,0,2
18/10/2018,EASTERN REGION,0,0,0,2,2
19/10/2018,EASTERN REGION,0,2,0,3,5
20/10/2018,EASTERN REGION,0,3,0,0,3
21/10/2018,EASTERN REGION,1,1,0,2,4
22/10/2018,EASTERN REGION,0,2,0,1,3
23/10/2018,EASTERN REGION,0,2,0,0,2
24/10/2018,EASTERN REGION,0,0,0,0,0
25/10/2018,EASTERN REGION,0,1,0,2,3
26/10/2018,EASTERN REGION,0,0,0,2,2
27/10/2018,EASTERN REGION,0,2,0,1,3
28/10/2018,EASTERN REGION,0,0,0,0,0
29/10/2018,EASTERN REGION,0,1,0,0,1
30/10/2018,EASTERN REGION,0,2,0,1,3
31/10/2018,EASTERN REGION,0,1,0,2,3
1/11/2018,EASTERN REGION,0,0,0,3,3
2/11/2018,EASTERN REGION,0,1,0,1,2
3/11/2018,EASTERN REGION,0,3,0,0,3
4/11/2018,EASTERN REGION,0,2,0,1,3
5/11/2018,EASTERN REGION,0,3,0,1,4
6/11/2018,EASTERN REGION,1,0,0,1,2
7/11/2018,EASTERN REGION,0,1,0,1,2
8/11/2018,EASTERN REGION,0,1,0,0,1
9/11/2018,EASTERN REGION,0,1,0,2,3
10/11/2018,EASTERN REGION,0,0,0,2,2
11/11/2018,EASTERN REGION,0,0,0,1,1
12/11/2018,EASTERN REGION,0,1,0,2,3
13/11/2018,EASTERN REGION,0,2,0,1,3
14/11/2018,EASTERN REGION,0,1,0,0,1
15/11/2018,EASTERN REGION,0,0,0,0,0
16/11/2018,EASTERN REGION,1,1,0,2,4
17/11/2018,EASTERN REGION,1,1,0,0,2
18/11/2018,EASTERN REGION,1,4,0,1,6
19/11/2018,EASTERN REGION,0,1,0,1,2
20/11/2018,EASTERN REGION,0,1,0,0,1
21/11/2018,EASTERN REGION,1,1,0,0,2
22/11/2018,EASTERN REGION,1,0,0,0,1
23/11/2018,EASTERN REGION,0,0,0,0,0
24/11/2018,EASTERN REGION,0,2,0,1,3
25/11/2018,EASTERN REGION,0,0,0,2,2
26/11/2018,EASTERN REGION,0,3,0,3,6
27/11/2018,EASTERN REGION,0,0,0,0,0
28/11/2018,EASTERN REGION,1,0,0,0,1
29/11/2018,EASTERN REGION,0,0,0,1,1
30/11/2018,EASTERN REGION,0,1,0,1,2
1/12/2018,EASTERN REGION,0,0,0,1,1
2/12/2018,EASTERN REGION,0,1,0,1,2
3/12/2018,EASTERN REGION,0,0,0,1,1
4/12/2018,EASTERN REGION,1,1,0,0,2
5/12/2018,EASTERN REGION,0,0,0,0,0
6/12/2018,EASTERN REGION,0,1,0,0,1
7/12/2018,EASTERN REGION,0,3,0,1,4
8/12/2018,EASTERN REGION,0,0,0,2,2
9/12/2018,EASTERN REGION,0,3,0,0,3
10/12/2018,EASTERN REGION,0,1,0,1,2
11/12/2018,EASTERN REGION,0,2,0,1,3
12/12/2018,EASTERN REGION,1,0,0,1,2
13/12/2018,EASTERN REGION,0,0,0,3,3
14/12/2018,EASTERN REGION,0,2,0,4,6
15/12/2018,EASTERN REGION,0,0,0,1,1
16/12/2018,EASTERN REGION,0,1,0,0,1
17/12/2018,EASTERN REGION,0,1,0,0,1
18/12/2018,EASTERN REGION,0,2,0,1,3
19/12/2018,EASTERN REGION,0,0,0,0,0
20/12/2018,EASTERN REGION,0,2,0,0,2
21/12/2018,EASTERN REGION,0,3,0,0,3
22/12/2018,EASTERN REGION,0,1,0,1,2
23/12/2018,EASTERN REGION,0,1,0,3,4
24/12/2018,EASTERN REGION,0,1,0,0,1
25/12/2018,EASTERN REGION,0,1,0,1,2
26/12/2018,EASTERN REGION,0,0,0,0,0
27/12/2018,EASTERN REGION,0,2,0,0,2
28/12/2018,EASTERN REGION,0,1,0,0,1
29/12/2018,EASTERN REGION,0,1,0,0,1
30/12/2018,EASTERN REGION,0,2,0,2,4
31/12/2018,EASTERN REGION,0,1,0,2,3
1/01/2019,EASTERN REGION,0,0,0,2,2
2/01/2019,EASTERN REGION,0,0,0,2,2
3/01/2019,EASTERN REGION,0,0,0,3,3
4/01/2019,EASTERN REGION,0,0,0,1,1
5/01/2019,EASTERN REGION,0,3,0,0,3
6/01/2019,EASTERN REGION,0,0,0,0,0
7/01/2019,EASTERN REGION,0,0,0,1,1
8/01/2019,EASTERN REGION,0,1,0,2,3
9/01/2019,EASTERN REGION,0,0,0,1,1
10/01/2019,EASTERN REGION,0,1,0,0,1
11/01/2019,EASTERN REGION,0,1,0,0,1
12/01/2019,EASTERN REGION,0,2,0,0,2
13/01/2019,EASTERN REGION,0,3,0,1,4
14/01/2019,EASTERN REGION,0,1,0,0,1
15/01/2019,EASTERN REGION,0,0,0,1,1
16/01/2019,EASTERN REGION,0,0,0,1,1
17/01/2019,EASTERN REGION,0,1,0,0,1
18/01/2019,EASTERN REGION,0,0,0,1,1
19/01/2019,EASTERN REGION,0,1,0,0,1
20/01/2019,EASTERN REGION,0,2,0,0,2
21/01/2019,EASTERN REGION,0,0,0,0,0
22/01/2019,EASTERN REGION,0,0,0,0,0
23/01/2019,EASTERN REGION,0,0,0,2,2
24/01/2019,EASTERN REGION,0,0,0,1,1
25/01/2019,EASTERN REGION,0,1,0,3,4
26/01/2019,EASTERN REGION,1,3,0,1,5
27/01/2019,EASTERN REGION,0,0,0,1,1
28/01/2019,EASTERN REGION,0,3,0,1,4
29/01/2019,EASTERN REGION,0,1,0,1,2
30/01/2019,EASTERN REGION,0,2,0,0,2
31/01/2019,EASTERN REGION,0,1,0,3,4
1/02/2019,EASTERN REGION,0,0,0,3,3
2/02/2019,EASTERN REGION,0,1,0,1,2
3/02/2019,EASTERN REGION,0,2,0,0,2
4/02/2019,EASTERN REGION,0,1,0,0,1
5/02/2019,EASTERN REGION,0,0,0,0,0
6/02/2019,EASTERN REGION,0,1,0,2,3
7/02/2019,EASTERN REGION,0,2,0,1,3
8/02/2019,EASTERN REGION,0,0,0,2,2
9/02/2019,EASTERN REGION,0,1,0,1,2
10/02/2019,EASTERN REGION,1,2,0,0,3
11/02/2019,EASTERN REGION,0,0,0,0,0
12/02/2019,EASTERN REGION,0,1,0,4,5
13/02/2019,EASTERN REGION,1,1,0,1,3
14/02/2019,EASTERN REGION,0,1,0,3,4
15/02/2019,EASTERN REGION,0,3,0,0,3
16/02/2019,EASTERN REGION,1,2,0,0,3
17/02/2019,EASTERN REGION,0,0,0,0,0
18/02/2019,EASTERN REGION,0,1,0,1,2
19/02/2019,EASTERN REGION,0,1,0,1,2
20/02/2019,EASTERN REGION,0,0,0,2,2
21/02/2019,EASTERN REGION,0,0,0,2,2
22/02/2019,EASTERN REGION,0,1,0,3,4
23/02/2019,EASTERN REGION,0,1,0,2,3
24/02/2019,EASTERN REGION,0,2,0,2,4
25/02/2019,EASTERN REGION,0,1,0,1,2
26/02/2019,EASTERN REGION,0,0,0,0,0
27/02/2019,EASTERN REGION,0,3,0,0,3
28/02/2019,EASTERN REGION,0,0,0,1,1
1/03/2019,EASTERN REGION,0,2,0,3,5
2/03/2019,EASTERN REGION,0,1,0,1,2
3/03/2019,EASTERN REGION,0,0,0,1,1
4/03/2019,EASTERN REGION,0,0,0,0,0
5/03/2019,EASTERN REGION,0,0,0,0,0
6/03/2019,EASTERN REGION,0,0,0,1,1
7/03/2019,EASTERN REGION,0,1,0,1,2
8/03/2019,EASTERN REGION,0,0,0,4,4
9/03/2019,EASTERN REGION,0,2,0,1,3
10/03/2019,EASTERN REGION,0,0,0,1,1
11/03/2019,EASTERN REGION,0,0,0,1,1
12/03/2019,EASTERN REGION,0,0,0,0,0
13/03/2019,EASTERN REGION,0,0,0,3,3
14/03/2019,EASTERN REGION,0,0,0,0,0
15/03/2019,EASTERN REGION,0,1,0,0,1
16/03/2019,EASTERN REGION,0,1,0,0,1
17/03/2019,EASTERN REGION,0,0,0,3,3
18/03/2019,EASTERN REGION,0,2,0,0,2
19/03/2019,EASTERN REGION,0,3,0,3,6
20/03/2019,EASTERN REGION,0,0,0,0,0
21/03/2019,EASTERN REGION,0,0,0,0,0
22/03/2019,EASTERN REGION,0,1,0,1,2
23/03/2019,EASTERN REGION,0,2,0,1,3
24/03/2019,EASTERN REGION,0,1,0,1,2
25/03/2019,EASTERN REGION,1,0,0,2,3
26/03/2019,EASTERN REGION,0,0,0,1,1
27/03/2019,EASTERN REGION,0,0,0,0,0
28/03/2019,EASTERN REGION,0,0,0,1,1
29/03/2019,EASTERN REGION,0,1,0,0,1
30/03/2019,EASTERN REGION,0,0,0,2,2
31/03/2019,EASTERN REGION,0,0,0,2,2
1/04/2019,EASTERN REGION,0,2,0,1,3
2/04/2019,EASTERN REGION,0,0,0,1,1
3/04/2019,EASTERN REGION,0,1,0,1,2
4/04/2019,EASTERN REGION,0,0,0,0,0
5/04/2019,EASTERN REGION,0,0,0,2,2
6/04/2019,EASTERN REGION,0,1,0,3,4
7/04/2019,EASTERN REGION,0,1,0,1,2
8/04/2019,EASTERN REGION,1,2,0,0,3
9/04/2019,EASTERN REGION,0,0,0,0,0
10/04/2019,EASTERN REGION,1,0,0,0,1
11/04/2019,EASTERN REGION,0,1,0,2,3
12/04/2019,EASTERN REGION,0,2,0,2,4
13/04/2019,EASTERN REGION,0,0,0,2,2
14/04/2019,EASTERN REGION,0,2,0,1,3
15/04/2019,EASTERN REGION,0,4,0,2,6
16/04/2019,EASTERN REGION,0,1,0,1,2
17/04/2019,EASTERN REGION,0,0,0,0,0
18/04/2019,EASTERN REGION,0,0,0,1,1
19/04/2019,EASTERN REGION,0,2,0,3,5
20/04/2019,EASTERN REGION,0,2,0,2,4
21/04/2019,EASTERN REGION,0,2,0,2,4
22/04/2019,EASTERN REGION,0,1,0,2,3
23/04/2019,EASTERN REGION,0,1,0,2,3
24/04/2019,EASTERN REGION,0,4,0,3,7
25/04/2019,EASTERN REGION,0,0,0,2,2
26/04/2019,EASTERN REGION,0,1,0,2,3
27/04/2019,EASTERN REGION,0,2,0,1,3
28/04/2019,EASTERN REGION,0,3,0,3,6
29/04/2019,EASTERN REGION,0,1,0,3,4
30/04/2019,EASTERN REGION,0,0,0,2,2
1/05/2019,EASTERN REGION,0,0,0,1,1
2/05/2019,EASTERN REGION,1,0,0,4,5
3/05/2019,EASTERN REGION,0,1,0,0,1
4/05/2019,EASTERN REGION,1,0,0,2,3
5/05/2019,EASTERN REGION,0,2,0,0,2
6/05/2019,EASTERN REGION,0,0,0,0,0
7/05/2019,EASTERN REGION,0,0,0,1,1
8/05/2019,EASTERN REGION,0,0,0,2,2
9/05/2019,EASTERN REGION,0,0,0,1,1
10/05/2019,EASTERN REGION,0,1,0,2,3
11/05/2019,EASTERN REGION,0,2,0,2,4
12/05/2019,EASTERN REGION,1,0,0,0,1
13/05/2019,EASTERN REGION,0,1,0,1,2
14/05/2019,EASTERN REGION,0,0,0,2,2
15/05/2019,EASTERN REGION,1,2,0,1,4
16/05/2019,EASTERN REGION,0,0,0,0,0
17/05/2019,EASTERN REGION,0,1,0,0,1
18/05/2019,EASTERN REGION,0,0,0,2,2
19/05/2019,EASTERN REGION,0,1,0,1,2
20/05/2019,EASTERN REGION,1,1,0,1,3
21/05/2019,EASTERN REGION,0,1,0,1,2
22/05/2019,EASTERN REGION,0,1,0,1,2
23/05/2019,EASTERN REGION,0,0,0,2,2
24/05/2019,EASTERN REGION,0,1,0,2,3
25/05/2019,EASTERN REGION,1,0,0,0,1
26/05/2019,EASTERN REGION,0,1,0,1,2
27/05/2019,EASTERN REGION,0,2,0,3,5
28/05/2019,EASTERN REGION,0,0,0,1,1
29/05/2019,EASTERN REGION,0,0,0,2,2
30/05/2019,EASTERN REGION,0,0,0,0,0
31/05/2019,EASTERN REGION,0,1,0,2,3
1/06/2019,EASTERN REGION,0,1,0,0,1
2/06/2019,EASTERN REGION,0,0,0,1,1
3/06/2019,EASTERN REGION,0,1,0,1,2
4/06/2019,EASTERN REGION,0,1,0,1,2
5/06/2019,EASTERN REGION,0,0,0,0,0
6/06/2019,EASTERN REGION,0,0,0,0,0
7/06/2019,EASTERN REGION,0,1,0,1,2
8/06/2019,EASTERN REGION,1,1,0,2,4
9/06/2019,EASTERN REGION,0,1,0,3,4
10/06/2019,EASTERN REGION,0,0,0,2,2
11/06/2019,EASTERN REGION,0,0,0,2,2
12/06/2019,EASTERN REGION,0,2,0,1,3
13/06/2019,EASTERN REGION,0,0,0,0,0
14/06/2019,EASTERN REGION,0,1,0,0,1
15/06/2019,EASTERN REGION,0,0,0,2,2
16/06/2019,EASTERN REGION,0,0,0,1,1
17/06/2019,EASTERN REGION,0,1,0,1,2
18/06/2019,EASTERN REGION,0,2,0,0,2
19/06/2019,EASTERN REGION,0,2,0,1,3
20/06/2019,EASTERN REGION,0,0,0,0,0
21/06/2019,EASTERN REGION,0,0,0,0,0
22/06/2019,EASTERN REGION,0,0,0,0,0
23/06/2019,EASTERN REGION,0,0,0,2,2
24/06/2019,EASTERN REGION,0,0,0,1,1
25/06/2019,EASTERN REGION,0,0,0,0,0
26/06/2019,EASTERN REGION,0,0,0,1,1
27/06/2019,EASTERN REGION,0,2,0,4,6
28/06/2019,EASTERN REGION,0,1,0,0,1
29/06/2019,EASTERN REGION,0,0,0,2,2
30/06/2019,EASTERN REGION,0,0,0,4,4
1/07/2019,EASTERN REGION,0,0,0,1,1
2/07/2019,EASTERN REGION,0,0,0,3,3
3/07/2019,EASTERN REGION,0,0,0,3,3
4/07/2019,EASTERN REGION,0,1,0,1,2
5/07/2019,EASTERN REGION,0,0,0,2,2
6/07/2019,EASTERN REGION,0,0,0,2,2
7/07/2019,EASTERN REGION,0,0,0,2,2
8/07/2019,EASTERN REGION,0,0,0,2,2
9/07/2019,EASTERN REGION,0,0,0,2,2
10/07/2019,EASTERN REGION,0,0,0,4,4
11/07/2019,EASTERN REGION,0,1,0,1,2
12/07/2019,EASTERN REGION,0,0,0,2,2
13/07/2019,EASTERN REGION,0,0,0,4,4
14/07/2019,EASTERN REGION,0,0,0,1,1
15/07/2019,EASTERN REGION,0,0,0,2,2
16/07/2019,EASTERN REGION,1,0,0,1,2
17/07/2019,EASTERN REGION,0,0,0,4,4
18/07/2019,EASTERN REGION,0,0,0,0,0
19/07/2019,EASTERN REGION,0,0,0,1,1
20/07/2019,EASTERN REGION,0,1,0,2,3
21/07/2019,EASTERN REGION,0,0,0,3,3
22/07/2019,EASTERN REGION,0,0,0,0,0
23/07/2019,EASTERN REGION,0,0,0,1,1
24/07/2019,EASTERN REGION,0,0,0,4,4
25/07/2019,EASTERN REGION,0,0,0,1,1
26/07/2019,EASTERN REGION,0,0,0,3,3
27/07/2019,EASTERN REGION,0,1,0,1,2
28/07/2019,EASTERN REGION,0,0,0,2,2
29/07/2019,EASTERN REGION,0,0,0,0,0
30/07/2019,EASTERN REGION,0,0,0,0,0
31/07/2019,EASTERN REGION,0,1,0,1,2
1/08/2019,EASTERN REGION,0,0,0,0,0
2/08/2019,EASTERN REGION,0,2,0,1,3
3/08/2019,EASTERN REGION,0,0,0,1,1
4/08/2019,EASTERN REGION,0,0,0,2,2
5/08/2019,EASTERN REGION,0,0,0,1,1
6/08/2019,EASTERN REGION,0,0,0,0,0
7/08/2019,EASTERN REGION,0,0,0,0,0
8/08/2019,EASTERN REGION,0,0,0,3,3
9/08/2019,EASTERN REGION,0,0,0,3,3
10/08/2019,EASTERN REGION,0,0,0,1,1
11/08/2019,EASTERN REGION,0,0,0,4,4
12/08/2019,EASTERN REGION,0,0,0,1,1
13/08/2019,EASTERN REGION,0,0,0,0,0
14/08/2019,EASTERN REGION,0,0,0,4,4
15/08/2019,EASTERN REGION,0,1,0,2,3
16/08/2019,EASTERN REGION,0,0,0,0,0
17/08/2019,EASTERN REGION,0,0,0,1,1
18/08/2019,EASTERN REGION,0,0,0,2,2
19/08/2019,EASTERN REGION,0,0,0,1,1
20/08/2019,EASTERN REGION,0,0,0,1,1
21/08/2019,EASTERN REGION,0,0,0,3,3
22/08/2019,EASTERN REGION,0,0,0,3,3
23/08/2019,EASTERN REGION,0,0,0,2,2
24/08/2019,EASTERN REGION,0,0,0,2,2
25/08/2019,EASTERN REGION,0,1,0,3,4
26/08/2019,EASTERN REGION,0,1,0,0,1
27/08/2019,EASTERN REGION,0,0,0,2,2
28/08/2019,EASTERN REGION,0,0,0,2,2
29/08/2019,EASTERN REGION,0,0,0,2,2
30/08/2019,EASTERN REGION,0,0,0,3,3
31/08/2019,EASTERN REGION,0,2,0,9,11
1/09/2019,EASTERN REGION,0,0,0,3,3
2/09/2019,EASTERN REGION,0,0,0,1,1
3/09/2019,EASTERN REGION,0,0,0,2,2
4/09/2019,EASTERN REGION,0,1,0,3,4
5/09/2019,EASTERN REGION,0,0,0,4,4
6/09/2019,EASTERN REGION,0,0,0,2,2
7/09/2019,EASTERN REGION,0,0,0,2,2
8/09/2019,EASTERN REGION,0,0,0,1,1
9/09/2019,EASTERN REGION,0,0,0,1,1
10/09/2019,EASTERN REGION,0,0,0,4,4
11/09/2019,EASTERN REGION,0,0,0,3,3
12/09/2019,EASTERN REGION,0,1,0,2,3
13/09/2019,EASTERN REGION,1,0,0,2,3
14/09/2019,EASTERN REGION,0,0,0,2,2
15/09/2019,EASTERN REGION,0,1,0,0,1
16/09/2019,EASTERN REGION,0,0,0,0,0
17/09/2019,EASTERN REGION,0,1,0,3,4
18/09/2019,EASTERN REGION,0,0,0,3,3
19/09/2019,EASTERN REGION,0,0,0,2,2
20/09/2019,EASTERN REGION,0,0,0,1,1
21/09/2019,EASTERN REGION,1,0,0,1,2
22/09/2019,EASTERN REGION,0,1,0,3,4
23/09/2019,EASTERN REGION,0,0,0,0,0
24/09/2019,EASTERN REGION,0,0,0,2,2
25/09/2019,EASTERN REGION,0,0,0,1,1
26/09/2019,EASTERN REGION,0,0,0,3,3
27/09/2019,EASTERN REGION,0,0,0,5,5
28/09/2019,EASTERN REGION,0,0,0,4,4
29/09/2019,EASTERN REGION,0,0,0,0,0
30/09/2019,EASTERN REGION,0,0,0,1,1
1/10/2019,EASTERN REGION,0,0,0,4,4
2/10/2019,EASTERN REGION,0,0,0,2,2
3/10/2019,EASTERN REGION,0,0,0,0,0
4/10/2019,EASTERN REGION,0,1,0,2,3
5/10/2019,EASTERN REGION,0,1,0,0,1
6/10/2019,EASTERN REGION,1,0,0,3,4
7/10/2019,EASTERN REGION,1,1,0,2,4
8/10/2019,EASTERN REGION,0,1,0,2,3
9/10/2019,EASTERN REGION,0,0,0,0,0
10/10/2019,EASTERN REGION,0,0,0,0,0
11/10/2019,EASTERN REGION,0,0,0,1,1
12/10/2019,EASTERN REGION,0,2,0,4,6
13/10/2019,EASTERN REGION,0,0,0,5,5
14/10/2019,EASTERN REGION,0,0,0,2,2
15/10/2019,EASTERN REGION,1,0,0,0,1
16/10/2019,EASTERN REGION,0,0,0,0,0
17/10/2019,EASTERN REGION,0,0,0,2,2
18/10/2019,EASTERN REGION,0,0,0,2,2
19/10/2019,EASTERN REGION,0,0,0,2,2
20/10/2019,EASTERN REGION,0,1,0,1,2
21/10/2019,EASTERN REGION,0,0,0,1,1
22/10/2019,EASTERN REGION,0,0,0,1,1
23/10/2019,EASTERN REGION,1,0,0,5,6
24/10/2019,EASTERN REGION,0,0,0,4,4
25/10/2019,EASTERN REGION,0,0,0,4,4
26/10/2019,EASTERN REGION,0,0,0,4,4
27/10/2019,EASTERN REGION,0,0,0,1,1
28/10/2019,EASTERN REGION,1,0,0,2,3
29/10/2019,EASTERN REGION,0,0,0,2,2
30/10/2019,EASTERN REGION,0,1,0,2,3
31/10/2019,EASTERN REGION,0,0,0,0,0
1/11/2019,EASTERN REGION,0,0,0,1,1
2/11/2019,EASTERN REGION,0,1,0,2,3
3/11/2019,EASTERN REGION,0,1,0,6,7
4/11/2019,EASTERN REGION,0,0,0,8,8
5/11/2019,EASTERN REGION,0,0,0,3,3
6/11/2019,EASTERN REGION,0,0,0,3,3
7/11/2019,EASTERN REGION,1,0,0,1,2
8/11/2019,EASTERN REGION,0,0,0,2,2
9/11/2019,EASTERN REGION,1,1,0,4,6
10/11/2019,EASTERN REGION,0,0,0,2,2
11/11/2019,EASTERN REGION,0,0,0,0,0
12/11/2019,EASTERN REGION,0,0,0,2,2
13/11/2019,EASTERN REGION,0,0,0,2,2
14/11/2019,EASTERN REGION,0,0,0,1,1
15/11/2019,EASTERN REGION,0,0,0,1,1
16/11/2019,EASTERN REGION,0,0,0,3,3
17/11/2019,EASTERN REGION,0,0,0,2,2
18/11/2019,EASTERN REGION,1,0,0,3,4
19/11/2019,EASTERN REGION,0,0,0,1,1
20/11/2019,EASTERN REGION,0,0,0,5,5
21/11/2019,EASTERN REGION,0,0,0,1,1
22/11/2019,EASTERN REGION,0,0,0,4,4
23/11/2019,EASTERN REGION,0,2,0,7,9
24/11/2019,EASTERN REGION,0,0,0,2,2
25/11/2019,EASTERN REGION,0,0,0,4,4
26/11/2019,EASTERN REGION,0,1,0,2,3
27/11/2019,EASTERN REGION,0,0,0,3,3
28/11/2019,EASTERN REGION,0,0,0,2,2
29/11/2019,EASTERN REGION,0,2,0,3,5
30/11/2019,EASTERN REGION,1,0,0,2,3
1/12/2019,EASTERN REGION,1,1,0,1,3
2/12/2019,EASTERN REGION,0,0,0,3,3
3/12/2019,EASTERN REGION,0,0,0,1,1
4/12/2019,EASTERN REGION,0,0,0,2,2
5/12/2019,EASTERN REGION,0,0,0,3,3
6/12/2019,EASTERN REGION,0,0,0,0,0
7/12/2019,EASTERN REGION,0,2,0,1,3
8/12/2019,EASTERN REGION,0,1,0,2,3
9/12/2019,EASTERN REGION,0,0,0,2,2
10/12/2019,EASTERN REGION,0,0,0,3,3
11/12/2019,EASTERN REGION,0,0,0,1,1
12/12/2019,EASTERN REGION,0,1,0,5,6
13/12/2019,EASTERN REGION,0,0,0,3,3
14/12/2019,EASTERN REGION,0,0,0,0,0
15/12/2019,EASTERN REGION,0,0,0,2,2
16/12/2019,EASTERN REGION,0,1,0,4,5
17/12/2019,EASTERN REGION,0,0,0,2,2
18/12/2019,EASTERN REGION,0,0,0,1,1
19/12/2019,EASTERN REGION,0,0,0,3,3
20/12/2019,EASTERN REGION,0,0,0,0,0
21/12/2019,EASTERN REGION,0,0,0,1,1
22/12/2019,EASTERN REGION,1,0,0,2,3
23/12/2019,EASTERN REGION,0,0,0,3,3
24/12/2019,EASTERN REGION,0,0,0,3,3
25/12/2019,EASTERN REGION,0,0,0,0,0
26/12/2019,EASTERN REGION,0,1,0,2,3
27/12/2019,EASTERN REGION,0,0,0,2,2
28/12/2019,EASTERN REGION,0,0,0,0,0
29/12/2019,EASTERN REGION,0,1,0,1,2
30/12/2019,EASTERN REGION,0,0,0,1,1
31/12/2019,EASTERN REGION,0,0,0,3,3
1/01/2020,EASTERN REGION,0,0,0,3,3
2/01/2020,EASTERN REGION,0,0,0,2,2
3/01/2020,EASTERN REGION,0,0,0,1,1
4/01/2020,EASTERN REGION,1,0,0,0,1
5/01/2020,EASTERN REGION,0,1,0,4,5
6/01/2020,EASTERN REGION,0,0,0,4,4
7/01/2020,EASTERN REGION,1,0,0,3,4
8/01/2020,EASTERN REGION,0,0,0,2,2
9/01/2020,EASTERN REGION,0,1,0,1,2
10/01/2020,EASTERN REGION,0,0,0,2,2
11/01/2020,EASTERN REGION,0,1,0,1,2
12/01/2020,EASTERN REGION,0,2,0,3,5
13/01/2020,EASTERN REGION,0,1,0,1,2
14/01/2020,EASTERN REGION,0,1,0,3,4
15/01/2020,EASTERN REGION,0,1,0,3,4
16/01/2020,EASTERN REGION,0,0,0,0,0
17/01/2020,EASTERN REGION,0,0,0,0,0
18/01/2020,EASTERN REGION,0,1,0,1,2
19/01/2020,EASTERN REGION,0,2,0,1,3
20/01/2020,EASTERN REGION,0,1,0,0,1
21/01/2020,EASTERN REGION,0,0,0,2,2
22/01/2020,EASTERN REGION,0,0,0,3,3
23/01/2020,EASTERN REGION,0,0,0,1,1
24/01/2020,EASTERN REGION,0,0,0,3,3
25/01/2020,EASTERN REGION,0,1,0,0,1
26/01/2020,EASTERN REGION,2,2,0,1,5
27/01/2020,EASTERN REGION,1,0,0,2,3
28/01/2020,EASTERN REGION,0,0,0,0,0
29/01/2020,EASTERN REGION,0,1,0,1,2
30/01/2020,EASTERN REGION,0,0,0,0,0
31/01/2020,EASTERN REGION,0,0,0,0,0
1/02/2020,EASTERN REGION,0,0,0,3,3
2/02/2020,EASTERN REGION,0,1,0,4,5
3/02/2020,EASTERN REGION,0,0,0,3,3
4/02/2020,EASTERN REGION,0,1,0,1,2
5/02/2020,EASTERN REGION,1,0,0,0,1
6/02/2020,EASTERN REGION,0,1,0,2,3
7/02/2020,EASTERN REGION,0,1,0,1,2
8/02/2020,EASTERN REGION,0,4,0,1,5
9/02/2020,EASTERN REGION,0,1,0,1,2
10/02/2020,EASTERN REGION,0,0,0,3,3
11/02/2020,EASTERN REGION,0,0,0,3,3
12/02/2020,EASTERN REGION,1,1,0,1,3
13/02/2020,EASTERN REGION,0,2,0,0,2
14/02/2020,EASTERN REGION,0,0,0,2,2
15/02/2020,EASTERN REGION,0,3,0,1,4
16/02/2020,EASTERN REGION,0,2,0,0,2
17/02/2020,EASTERN REGION,0,2,0,2,4
18/02/2020,EASTERN REGION,0,0,0,1,1
19/02/2020,EASTERN REGION,0,1,0,1,2
20/02/2020,EASTERN REGION,0,1,0,3,4
21/02/2020,EASTERN REGION,0,1,0,2,3
22/02/2020,EASTERN REGION,0,1,0,4,5
23/02/2020,EASTERN REGION,0,1,0,2,3
24/02/2020,EASTERN REGION,0,0,0,0,0
25/02/2020,EASTERN REGION,0,1,0,1,2
26/02/2020,EASTERN REGION,0,1,0,0,1
27/02/2020,EASTERN REGION,0,1,0,1,2
28/02/2020,EASTERN REGION,0,1,0,1,2
29/02/2020,EASTERN REGION,0,0,0,1,1
1/03/2020,EASTERN REGION,0,2,0,3,5
2/03/2020,EASTERN REGION,2,0,0,3,5
3/03/2020,EASTERN REGION,0,0,0,1,1
4/03/2020,EASTERN REGION,0,1,0,2,3
5/03/2020,EASTERN REGION,1,0,0,4,5
6/03/2020,EASTERN REGION,0,1,0,4,5
7/03/2020,EASTERN REGION,1,1,0,2,4
8/03/2020,EASTERN REGION,0,2,0,4,6
9/03/2020,EASTERN REGION,0,2,0,1,3
10/03/2020,EASTERN REGION,0,0,0,1,1
11/03/2020,EASTERN REGION,0,1,0,1,2
12/03/2020,EASTERN REGION,0,0,0,2,2
13/03/2020,EASTERN REGION,0,0,0,1,1
14/03/2020,EASTERN REGION,1,1,0,0,2
15/03/2020,EASTERN REGION,0,1,0,4,5
16/03/2020,EASTERN REGION,0,0,0,2,2
17/03/2020,EASTERN REGION,1,1,0,2,4
18/03/2020,EASTERN REGION,0,0,0,0,0
19/03/2020,EASTERN REGION,0,2,0,3,5
20/03/2020,EASTERN REGION,0,0,0,1,1
21/03/2020,EASTERN REGION,0,1,0,1,2
22/03/2020,EASTERN REGION,0,1,0,1,2
23/03/2020,EASTERN REGION,0,1,0,1,2
24/03/2020,EASTERN REGION,0,0,0,2,2
25/03/2020,EASTERN REGION,0,2,0,1,3
26/03/2020,EASTERN REGION,0,0,0,1,1
27/03/2020,EASTERN REGION,0,0,0,0,0
28/03/2020,EASTERN REGION,0,2,0,1,3
29/03/2020,EASTERN REGION,0,3,0,1,4
30/03/2020,EASTERN REGION,0,0,0,1,1
31/03/2020,EASTERN REGION,0,0,0,0,0
1/04/2020,EASTERN REGION,0,0,0,1,1
2/04/2020,EASTERN REGION,0,0,0,2,2
3/04/2020,EASTERN REGION,0,0,0,1,1
4/04/2020,EASTERN REGION,0,0,0,2,2
5/04/2020,EASTERN REGION,0,1,0,2,3
6/04/2020,EASTERN REGION,0,0,0,0,0
7/04/2020,EASTERN REGION,1,2,0,1,4
8/04/2020,EASTERN REGION,0,1,0,0,1
9/04/2020,EASTERN REGION,0,1,0,2,3
10/04/2020,EASTERN REGION,0,0,0,1,1
11/04/2020,EASTERN REGION,0,0,0,0,0
12/04/2020,EASTERN REGION,0,0,0,0,0
13/04/2020,EASTERN REGION,0,0,0,1,1
14/04/2020,EASTERN REGION,0,0,0,0,0
15/04/2020,EASTERN REGION,0,0,0,1,1
16/04/2020,EASTERN REGION,0,0,0,0,0
17/04/2020,EASTERN REGION,0,0,0,0,0
18/04/2020,EASTERN REGION,0,1,0,0,1
19/04/2020,EASTERN REGION,0,1,0,4,5
20/04/2020,EASTERN REGION,0,0,0,0,0
21/04/2020,EASTERN REGION,0,0,0,0,0
22/04/2020,EASTERN REGION,0,2,0,0,2
23/04/2020,EASTERN REGION,0,1,0,0,1
24/04/2020,EASTERN REGION,0,1,0,0,1
25/04/2020,EASTERN REGION,0,1,0,0,1
26/04/2020,EASTERN REGION,0,0,0,1,1
27/04/2020,EASTERN REGION,0,1,0,0,1
28/04/2020,EASTERN REGION,0,1,0,1,2
29/04/2020,EASTERN REGION,0,0,0,0,0
30/04/2020,EASTERN REGION,0,1,0,1,2
1/05/2020,EASTERN REGION,0,1,0,0,1
2/05/2020,EASTERN REGION,0,0,0,1,1
3/05/2020,EASTERN REGION,0,2,0,0,2
4/05/2020,EASTERN REGION,0,0,0,0,0
5/05/2020,EASTERN REGION,0,0,0,2,2
6/05/2020,EASTERN REGION,0,0,0,0,0
7/05/2020,EASTERN REGION,0,2,0,0,2
8/05/2020,EASTERN REGION,0,0,0,0,0
9/05/2020,EASTERN REGION,0,0,0,0,0
10/05/2020,EASTERN REGION,0,0,0,1,1
11/05/2020,EASTERN REGION,0,0,0,0,0
12/05/2020,EASTERN REGION,0,0,0,0,0
13/05/2020,EASTERN REGION,0,1,0,2,3
14/05/2020,EASTERN REGION,1,1,0,1,3
15/05/2020,EASTERN REGION,0,0,0,1,1
16/05/2020,EASTERN REGION,0,3,0,4,7
17/05/2020,EASTERN REGION,0,0,0,0,0
18/05/2020,EASTERN REGION,0,0,0,1,1
19/05/2020,EASTERN REGION,0,1,0,1,2
20/05/2020,EASTERN REGION,0,1,0,1,2
21/05/2020,EASTERN REGION,0,1,0,0,1
22/05/2020,EASTERN REGION,0,1,0,0,1
23/05/2020,EASTERN REGION,0,3,0,2,5
24/05/2020,EASTERN REGION,0,3,0,1,4
25/05/2020,EASTERN REGION,0,0,0,0,0
26/05/2020,EASTERN REGION,0,0,0,0,0
27/05/2020,EASTERN REGION,0,1,0,0,1
28/05/2020,EASTERN REGION,0,0,0,2,2
29/05/2020,EASTERN REGION,0,3,0,3,6
30/05/2020,EASTERN REGION,0,1,0,1,2
31/05/2020,EASTERN REGION,0,3,0,1,4
1/06/2020,EASTERN REGION,0,1,0,0,1
2/06/2020,EASTERN REGION,0,0,0,0,0
3/06/2020,EASTERN REGION,0,1,0,1,2
4/06/2020,EASTERN REGION,0,1,0,1,2
5/06/2020,EASTERN REGION,0,2,0,1,3
6/06/2020,EASTERN REGION,0,2,0,3,5
7/06/2020,EASTERN REGION,0,0,0,3,3
8/06/2020,EASTERN REGION,0,1,0,2,3
9/06/2020,EASTERN REGION,0,0,0,3,3
10/06/2020,EASTERN REGION,0,0,0,1,1
11/06/2020,EASTERN REGION,0,0,0,1,1
12/06/2020,EASTERN REGION,0,1,0,0,1
13/06/2020,EASTERN REGION,0,1,0,4,5
14/06/2020,EASTERN REGION,0,0,0,0,0
15/06/2020,EASTERN REGION,0,0,0,3,3
16/06/2020,EASTERN REGION,0,0,0,0,0
17/06/2020,EASTERN REGION,0,0,0,0,0
18/06/2020,EASTERN REGION,1,0,0,0,1
19/06/2020,EASTERN REGION,0,1,0,0,1
20/06/2020,EASTERN REGION,0,1,0,0,1
21/06/2020,EASTERN REGION,0,1,0,1,2
22/06/2020,EASTERN REGION,0,0,0,1,1
23/06/2020,EASTERN REGION,0,1,0,0,1
24/06/2020,EASTERN REGION,0,0,0,0,0
25/06/2020,EASTERN REGION,0,0,0,0,0
26/06/2020,EASTERN REGION,1,1,0,2,4
27/06/2020,EASTERN REGION,0,0,0,0,0
28/06/2020,EASTERN REGION,0,1,0,1,2
29/06/2020,EASTERN REGION,1,0,0,0,1
30/06/2020,EASTERN REGION,0,0,0,1,1
